date,deepSleepTime,shallowSleepTime,wakeTime,start,stop,REMTime,naps,totalSleep
2020-08-28,80,268,0,2020-08-27 20:29:00+0000,2020-08-28 02:17:00+0000,0,,348
2020-08-29,117,410,0,2020-08-28 20:35:00+0000,2020-08-29 05:22:00+0000,0,,527
2020-08-30,161,381,2,2020-08-29 20:31:00+0000,2020-08-30 05:35:00+0000,0,,542
2020-08-31,167,342,2,2020-08-30 20:52:00+0000,2020-08-31 05:23:00+0000,0,,509
2020-09-01,131,458,0,2020-08-31 19:50:00+0000,2020-09-01 05:39:00+0000,0,,589
2020-09-02,139,373,0,2020-09-01 20:33:00+0000,2020-09-02 05:05:00+0000,0,,512
2020-09-03,148,408,2,2020-09-02 20:50:00+0000,2020-09-03 06:08:00+0000,0,,556
2020-09-04,169,346,0,2020-09-03 20:39:00+0000,2020-09-04 05:14:00+0000,0,,515
2020-09-05,220,235,0,2020-09-04 21:09:00+0000,2020-09-05 04:44:00+0000,0,,455
2020-09-06,147,378,0,2020-09-05 20:12:00+0000,2020-09-06 04:57:00+0000,0,,525
2020-09-07,169,369,0,2020-09-06 20:36:00+0000,2020-09-07 05:34:00+0000,0,,538
2020-09-08,86,434,0,2020-09-07 20:38:00+0000,2020-09-08 05:18:00+0000,0,,520
2020-09-09,145,406,0,2020-09-08 20:06:00+0000,2020-09-09 05:17:00+0000,0,,551
2020-09-10,160,397,17,2020-09-09 19:50:00+0000,2020-09-10 05:24:00+0000,0,,557
2020-09-11,154,365,0,2020-09-10 20:44:00+0000,2020-09-11 05:23:00+0000,0,,519
2020-09-12,191,349,0,2020-09-11 20:33:00+0000,2020-09-12 05:33:00+0000,0,,540
2020-09-13,181,383,0,2020-09-12 19:56:00+0000,2020-09-13 05:20:00+0000,0,,564
2020-09-14,138,455,9,2020-09-13 19:33:00+0000,2020-09-14 05:35:00+0000,0,,593
2020-09-15,66,510,0,2020-09-14 20:03:00+0000,2020-09-15 05:39:00+0000,0,,576
2020-09-16,109,483,0,2020-09-15 19:46:00+0000,2020-09-16 05:38:00+0000,0,,592
2020-09-17,134,352,2,2020-09-16 20:55:00+0000,2020-09-17 05:03:00+0000,0,,486
2020-09-18,128,415,0,2020-09-17 19:57:00+0000,2020-09-18 05:00:00+0000,0,,543
2020-09-19,221,353,0,2020-09-18 20:11:00+0000,2020-09-19 05:45:00+0000,0,,574
2020-09-20,117,417,0,2020-09-19 20:26:00+0000,2020-09-20 05:20:00+0000,0,,534
2020-09-21,176,373,2,2020-09-20 20:20:00+0000,2020-09-21 05:31:00+0000,0,,549
2020-09-22,118,461,0,2020-09-21 19:59:00+0000,2020-09-22 05:38:00+0000,0,,579
2020-09-23,116,425,0,2020-09-22 20:27:00+0000,2020-09-23 05:28:00+0000,0,,541
2020-09-24,151,398,0,2020-09-23 20:21:00+0000,2020-09-24 05:30:00+0000,0,,549
2020-09-25,136,417,0,2020-09-24 20:19:00+0000,2020-09-25 05:32:00+0000,0,,553
2020-09-26,156,417,0,2020-09-25 20:16:00+0000,2020-09-26 05:49:00+0000,0,,573
2020-09-27,143,397,2,2020-09-26 20:01:00+0000,2020-09-27 05:03:00+0000,0,,540
2020-09-28,161,433,0,2020-09-27 19:41:00+0000,2020-09-28 05:35:00+0000,0,,594
2020-09-29,226,350,0,2020-09-28 20:10:00+0000,2020-09-29 05:46:00+0000,0,,576
2020-09-30,167,370,3,2020-09-29 20:36:00+0000,2020-09-30 05:36:00+0000,0,,537
2020-10-01,162,531,58,2020-09-30 17:16:00+0000,2020-10-01 05:47:00+0000,0,,693
2020-10-02,140,399,0,2020-10-01 20:57:00+0000,2020-10-02 05:56:00+0000,0,,539
2020-10-03,138,405,0,2020-10-02 20:36:00+0000,2020-10-03 05:39:00+0000,0,,543
2020-10-04,115,286,0,2020-10-03 20:46:00+0000,2020-10-04 03:27:00+0000,0,,401
2020-10-05,144,420,0,2020-10-04 20:00:00+0000,2020-10-05 05:24:00+0000,0,,564
2020-10-06,88,444,0,2020-10-05 20:42:00+0000,2020-10-06 05:34:00+0000,0,,532
2020-10-07,156,376,0,2020-10-06 19:37:00+0000,2020-10-07 04:29:00+0000,0,,532
2020-10-08,196,326,0,2020-10-07 19:57:00+0000,2020-10-08 04:39:00+0000,0,,522
2020-10-09,184,391,0,2020-10-08 20:02:00+0000,2020-10-09 05:37:00+0000,0,,575
2020-10-10,166,366,0,2020-10-09 19:55:00+0000,2020-10-10 04:47:00+0000,0,,532
2020-10-11,122,348,0,2020-10-10 19:26:00+0000,2020-10-11 03:16:00+0000,0,,470
2020-10-12,142,336,2,2020-10-11 20:32:00+0000,2020-10-12 04:32:00+0000,0,,478
2020-10-13,142,390,0,2020-10-12 20:04:00+0000,2020-10-13 04:56:00+0000,0,,532
2020-10-14,107,428,2,2020-10-13 20:23:00+0000,2020-10-14 05:20:00+0000,0,,535
2020-10-15,169,391,2,2020-10-14 20:20:00+0000,2020-10-15 05:42:00+0000,0,,560
2020-10-16,78,430,0,2020-10-15 20:15:00+0000,2020-10-16 04:43:00+0000,0,,508
2020-10-17,132,444,0,2020-10-16 20:16:00+0000,2020-10-17 05:52:00+0000,0,,576
2020-10-18,220,342,2,2020-10-17 20:33:00+0000,2020-10-18 05:57:00+0000,0,,562
2020-10-19,177,352,0,2020-10-18 20:39:00+0000,2020-10-19 05:28:00+0000,0,,529
2020-10-20,156,322,0,2020-10-19 21:10:00+0000,2020-10-20 05:08:00+0000,0,,478
2020-10-21,221,343,2,2020-10-20 19:38:00+0000,2020-10-21 05:04:00+0000,0,,564
2020-10-22,123,417,0,2020-10-21 20:21:00+0000,2020-10-22 05:21:00+0000,0,,540
2020-10-23,132,436,0,2020-10-22 20:09:00+0000,2020-10-23 05:37:00+0000,0,,568
2020-10-24,178,370,2,2020-10-23 20:26:00+0000,2020-10-24 05:36:00+0000,0,,548
2020-10-25,114,471,0,2020-10-24 20:17:00+0000,2020-10-25 06:02:00+0000,0,,585
2020-10-26,163,389,0,2020-10-25 20:35:00+0000,2020-10-26 05:47:00+0000,0,,552
2020-10-27,120,415,0,2020-10-26 20:20:00+0000,2020-10-27 05:15:00+0000,0,,535
2020-10-28,192,350,0,2020-10-27 20:54:00+0000,2020-10-28 05:56:00+0000,0,,542
2020-10-29,157,308,0,2020-10-28 22:13:00+0000,2020-10-29 05:58:00+0000,0,,465
2020-10-30,129,399,0,2020-10-29 21:03:00+0000,2020-10-30 05:51:00+0000,0,,528
2020-10-31,144,426,0,2020-10-30 20:40:00+0000,2020-10-31 06:10:00+0000,0,,570
2020-11-01,138,425,0,2020-10-31 20:32:00+0000,2020-11-01 05:55:00+0000,0,,563
2020-11-02,75,252,0,2020-11-01 21:40:00+0000,2020-11-02 03:07:00+0000,0,,327
2020-11-03,110,381,2,2020-11-02 21:14:00+0000,2020-11-03 05:27:00+0000,0,,491
2020-11-04,135,363,3,2020-11-03 21:19:00+0000,2020-11-04 05:40:00+0000,0,,498
2020-11-05,140,305,34,2020-11-04 21:28:00+0000,2020-11-05 05:27:00+0000,0,,445
2020-11-06,141,358,2,2020-11-05 21:24:00+0000,2020-11-06 05:45:00+0000,0,,499
2020-11-07,172,371,4,2020-11-06 21:13:00+0000,2020-11-07 06:20:00+0000,0,,543
2020-11-08,153,333,2,2020-11-07 20:25:00+0000,2020-11-08 04:33:00+0000,0,,486
2020-11-09,131,363,0,2020-11-08 21:18:00+0000,2020-11-09 05:32:00+0000,0,,494
2020-11-10,49,491,0,2020-11-09 20:30:00+0000,2020-11-10 05:30:00+0000,0,,540
2020-11-11,157,425,0,2020-11-10 20:09:00+0000,2020-11-11 05:51:00+0000,0,,582
2020-11-12,185,342,2,2020-11-11 20:45:00+0000,2020-11-12 05:34:00+0000,0,,527
2020-11-13,204,330,0,2020-11-12 20:43:00+0000,2020-11-13 05:37:00+0000,0,,534
2020-11-14,218,339,0,2020-11-13 20:40:00+0000,2020-11-14 05:57:00+0000,0,,557
2020-11-15,141,367,0,2020-11-14 21:25:00+0000,2020-11-15 05:53:00+0000,0,,508
2020-11-16,171,281,4,2020-11-15 21:34:00+0000,2020-11-16 05:10:00+0000,0,,452
2020-11-17,132,376,2,2020-11-16 21:14:00+0000,2020-11-17 05:44:00+0000,0,,508
2020-11-18,135,357,0,2020-11-17 21:44:00+0000,2020-11-18 05:56:00+0000,0,,492
2020-11-19,102,380,0,2020-11-18 21:54:00+0000,2020-11-19 05:56:00+0000,0,,482
2020-11-20,128,352,0,2020-11-19 21:38:00+0000,2020-11-20 05:38:00+0000,0,,480
2020-11-21,105,454,0,2020-11-20 20:47:00+0000,2020-11-21 06:06:00+0000,0,,559
2020-11-22,109,495,0,2020-11-21 20:28:00+0000,2020-11-22 06:32:00+0000,0,,604
2020-11-23,215,482,10,2020-11-22 17:57:00+0000,2020-11-23 05:44:00+0000,0,,697
2020-11-24,175,363,0,2020-11-23 20:50:00+0000,2020-11-24 05:48:00+0000,0,,538
2020-11-25,80,422,0,2020-11-24 20:54:00+0000,2020-11-25 05:16:00+0000,0,,502
2020-11-26,146,393,0,2020-11-25 20:08:00+0000,2020-11-26 05:07:00+0000,0,,539
2020-11-27,195,357,14,2020-11-26 20:23:00+0000,2020-11-27 05:49:00+0000,0,,552
2020-11-28,78,494,0,2020-11-27 20:39:00+0000,2020-11-28 06:11:00+0000,0,,572
2020-11-29,154,383,0,2020-11-28 21:06:00+0000,2020-11-29 06:03:00+0000,0,,537
2020-11-30,89,431,0,2020-11-29 21:06:00+0000,2020-11-30 05:46:00+0000,0,,520
2020-12-01,157,339,0,2020-11-30 21:27:00+0000,2020-12-01 05:43:00+0000,0,,496
2020-12-02,169,317,0,2020-12-01 21:27:00+0000,2020-12-02 05:33:00+0000,0,,486
2020-12-03,153,375,0,2020-12-02 20:49:00+0000,2020-12-03 05:37:00+0000,0,,528
2020-12-04,87,445,0,2020-12-03 20:50:00+0000,2020-12-04 05:42:00+0000,0,,532
2020-12-05,214,357,0,2020-12-04 20:26:00+0000,2020-12-05 05:57:00+0000,0,,571
2020-12-06,171,379,0,2020-12-05 20:55:00+0000,2020-12-06 06:05:00+0000,0,,550
2020-12-07,182,369,2,2020-12-06 20:06:00+0000,2020-12-07 05:19:00+0000,0,,551
2020-12-08,149,376,0,2020-12-07 20:42:00+0000,2020-12-08 05:27:00+0000,0,,525
2020-12-09,193,319,0,2020-12-08 21:09:00+0000,2020-12-09 05:41:00+0000,0,,512
2020-12-10,155,384,0,2020-12-09 20:35:00+0000,2020-12-10 05:34:00+0000,0,,539
2020-12-11,158,452,0,2020-12-10 19:51:00+0000,2020-12-11 06:01:00+0000,0,,610
2020-12-12,163,391,0,2020-12-11 21:11:00+0000,2020-12-12 06:25:00+0000,0,,554
2020-12-13,91,399,1,2020-12-12 21:00:00+0000,2020-12-13 05:11:00+0000,0,,490
2020-12-14,146,418,0,2020-12-13 20:31:00+0000,2020-12-14 05:55:00+0000,0,,564
2020-12-15,148,356,0,2020-12-14 21:23:00+0000,2020-12-15 05:47:00+0000,0,,504
2020-12-16,157,289,0,2020-12-15 21:23:00+0000,2020-12-16 04:49:00+0000,0,,446
2020-12-17,90,521,88,2020-12-16 21:15:00+0000,2020-12-17 08:54:00+0000,0,,611
2020-12-18,141,345,0,2020-12-17 21:47:00+0000,2020-12-18 05:53:00+0000,0,,486
2020-12-19,137,376,0,2020-12-18 21:30:00+0000,2020-12-19 06:03:00+0000,0,,513
2020-12-20,135,355,0,2020-12-19 21:31:00+0000,2020-12-20 05:41:00+0000,0,,490
2020-12-21,96,418,0,2020-12-20 21:14:00+0000,2020-12-21 05:48:00+0000,0,,514
2020-12-22,131,431,3,2020-12-21 20:22:00+0000,2020-12-22 05:47:00+0000,0,,562
2020-12-23,115,227,0,2020-12-22 22:20:00+0000,2020-12-23 04:02:00+0000,0,,342
2020-12-24,156,309,0,2020-12-23 21:21:00+0000,2020-12-24 05:06:00+0000,0,,465
2020-12-25,138,294,0,2020-12-24 21:07:00+0000,2020-12-25 04:19:00+0000,0,,432
2020-12-26,185,365,0,2020-12-25 20:58:00+0000,2020-12-26 06:08:00+0000,0,,550
2020-12-27,163,382,0,2020-12-26 21:29:00+0000,2020-12-27 06:34:00+0000,0,,545
2020-12-28,181,310,0,2020-12-27 21:09:00+0000,2020-12-28 05:20:00+0000,0,,491
2020-12-29,193,343,2,2020-12-28 21:04:00+0000,2020-12-29 06:02:00+0000,0,,536
2020-12-30,170,318,0,2020-12-29 21:42:00+0000,2020-12-30 05:50:00+0000,0,,488
2020-12-31,170,394,0,2020-12-30 21:19:00+0000,2020-12-31 06:43:00+0000,0,,564
2021-01-01,206,337,0,2020-12-31 21:26:00+0000,2021-01-01 06:29:00+0000,0,,543
2021-01-02,96,442,0,2021-01-01 21:35:00+0000,2021-01-02 06:33:00+0000,0,,538
2021-01-03,187,372,0,2021-01-02 21:34:00+0000,2021-01-03 06:53:00+0000,0,,559
2021-01-04,120,375,0,2021-01-03 21:28:00+0000,2021-01-04 05:43:00+0000,0,,495
2021-01-05,155,316,2,2021-01-04 22:00:00+0000,2021-01-05 05:53:00+0000,0,,471
2021-01-06,141,377,0,2021-01-05 21:14:00+0000,2021-01-06 05:52:00+0000,0,,518
2021-01-07,118,220,0,2021-01-06 22:25:00+0000,2021-01-07 04:03:00+0000,0,,338
2021-01-08,180,281,0,2021-01-07 21:39:00+0000,2021-01-08 05:20:00+0000,0,,461
2021-01-09,163,351,0,2021-01-08 21:55:00+0000,2021-01-09 06:29:00+0000,0,,514
2021-01-10,111,430,0,2021-01-09 21:42:00+0000,2021-01-10 06:43:00+0000,0,,541
2021-01-11,121,391,0,2021-01-10 21:23:00+0000,2021-01-11 05:55:00+0000,0,,512
2021-01-12,115,279,0,2021-01-11 21:29:00+0000,2021-01-12 04:03:00+0000,0,,394
2021-01-13,152,379,0,2021-01-12 21:00:00+0000,2021-01-13 05:51:00+0000,0,,531
2021-01-14,140,280,0,2021-01-13 21:21:00+0000,2021-01-14 04:21:00+0000,0,,420
2021-01-15,109,394,0,2021-01-14 21:18:00+0000,2021-01-15 05:41:00+0000,0,,503
2021-01-16,200,327,0,2021-01-15 21:40:00+0000,2021-01-16 06:27:00+0000,0,,527
2021-01-17,220,267,0,2021-01-16 21:32:00+0000,2021-01-17 05:39:00+0000,0,,487
2021-01-18,199,317,0,2021-01-17 21:20:00+0000,2021-01-18 05:56:00+0000,0,,516
2021-01-19,119,368,0,2021-01-18 21:14:00+0000,2021-01-19 05:21:00+0000,0,,487
2021-01-20,121,424,0,2021-01-19 19:57:00+0000,2021-01-20 05:02:00+0000,0,,545
2021-01-21,167,400,0,2021-01-20 20:21:00+0000,2021-01-21 05:48:00+0000,0,,567
2021-01-22,148,390,0,2021-01-21 20:52:00+0000,2021-01-22 05:50:00+0000,0,,538
2021-01-23,166,339,0,2021-01-22 20:45:00+0000,2021-01-23 05:10:00+0000,0,,505
2021-01-24,79,311,0,2021-01-23 21:33:00+0000,2021-01-24 04:03:00+0000,0,,390
2021-01-25,191,303,0,2021-01-24 22:12:00+0000,2021-01-25 06:26:00+0000,0,,494
2021-01-26,139,334,0,2021-01-25 22:05:00+0000,2021-01-26 05:58:00+0000,0,,473
2021-01-27,180,345,2,2021-01-26 20:56:00+0000,2021-01-27 05:43:00+0000,0,,525
2021-01-28,163,368,0,2021-01-27 20:47:00+0000,2021-01-28 05:38:00+0000,0,,531
2021-01-29,191,292,0,2021-01-28 22:14:00+0000,2021-01-29 06:17:00+0000,0,,483
2021-01-30,155,197,0,2021-01-29 23:52:00+0000,2021-01-30 05:44:00+0000,0,,352
2021-01-31,97,468,0,2021-01-30 21:21:00+0000,2021-01-31 06:46:00+0000,0,,565
2021-02-01,80,400,2,2021-01-31 22:24:00+0000,2021-02-01 06:26:00+0000,0,,480
2021-02-02,124,279,2,2021-02-01 21:55:00+0000,2021-02-02 04:40:00+0000,0,,403
2021-02-03,179,361,0,2021-02-02 21:02:00+0000,2021-02-03 06:02:00+0000,0,,540
2021-02-04,128,412,0,2021-02-03 20:59:00+0000,2021-02-04 05:59:00+0000,0,,540
2021-02-05,184,384,2,2021-02-04 20:39:00+0000,2021-02-05 06:09:00+0000,0,,568
2021-02-06,119,422,14,2021-02-05 21:11:00+0000,2021-02-06 06:26:00+0000,0,,541
2021-02-07,147,354,2,2021-02-06 21:26:00+0000,2021-02-07 05:49:00+0000,0,,501
2021-02-08,85,351,0,2021-02-07 21:19:00+0000,2021-02-08 04:35:00+0000,0,,436
2021-02-09,149,345,0,2021-02-08 20:36:00+0000,2021-02-09 04:50:00+0000,0,,494
2021-02-10,210,287,11,2021-02-09 21:13:00+0000,2021-02-10 05:41:00+0000,0,,497
2021-02-11,156,332,0,2021-02-10 21:03:00+0000,2021-02-11 05:11:00+0000,0,,488
2021-02-12,92,270,2,2021-02-11 21:40:00+0000,2021-02-12 03:44:00+0000,0,,362
2021-02-13,192,285,2,2021-02-12 21:59:00+0000,2021-02-13 05:58:00+0000,0,,477
2021-02-14,194,316,0,2021-02-13 21:26:00+0000,2021-02-14 05:56:00+0000,0,,510
2021-02-15,143,345,0,2021-02-14 21:20:00+0000,2021-02-15 05:28:00+0000,0,,488
2021-02-16,208,277,0,2021-02-15 21:19:00+0000,2021-02-16 05:24:00+0000,0,,485
2021-02-17,135,343,0,2021-02-16 20:57:00+0000,2021-02-17 04:55:00+0000,0,,478
2021-02-18,129,404,0,2021-02-17 20:08:00+0000,2021-02-18 05:01:00+0000,0,,533
2021-02-19,147,396,0,2021-02-18 20:46:00+0000,2021-02-19 05:49:00+0000,0,,543
2021-02-20,197,338,0,2021-02-19 21:09:00+0000,2021-02-20 06:04:00+0000,0,,535
2021-02-21,192,360,0,2021-02-20 21:04:00+0000,2021-02-21 06:16:00+0000,0,,552
2021-02-22,145,305,0,2021-02-21 21:20:00+0000,2021-02-22 04:50:00+0000,0,,450
2021-02-23,140,321,0,2021-02-22 21:37:00+0000,2021-02-23 05:18:00+0000,0,,461
2021-02-24,139,398,0,2021-02-23 20:44:00+0000,2021-02-24 05:41:00+0000,0,,537
2021-02-25,157,311,2,2021-02-24 21:53:00+0000,2021-02-25 05:43:00+0000,0,,468
2021-02-26,134,299,0,2021-02-25 22:00:00+0000,2021-02-26 05:13:00+0000,0,,433
2021-02-27,256,367,10,2021-02-26 20:41:00+0000,2021-02-27 07:14:00+0000,0,,623
2021-02-28,166,311,0,2021-02-27 21:11:00+0000,2021-02-28 05:08:00+0000,0,,477
2021-03-01,210,307,2,2021-02-28 21:00:00+0000,2021-03-01 05:39:00+0000,0,,517
2021-03-02,97,367,0,2021-03-01 20:46:00+0000,2021-03-02 04:30:00+0000,0,,464
2021-03-03,145,290,0,2021-03-02 21:24:00+0000,2021-03-03 04:39:00+0000,0,,435
2021-03-04,132,375,0,2021-03-03 21:05:00+0000,2021-03-04 05:32:00+0000,0,,507
2021-03-05,169,378,0,2021-03-04 20:15:00+0000,2021-03-05 05:22:00+0000,0,,547
2021-03-06,99,415,0,2021-03-05 21:19:00+0000,2021-03-06 05:53:00+0000,0,,514
2021-03-07,145,349,0,2021-03-06 22:30:00+0000,2021-03-07 06:44:00+0000,0,,494
2021-03-08,146,375,2,2021-03-07 21:04:00+0000,2021-03-08 05:47:00+0000,0,,521
2021-03-09,146,357,0,2021-03-08 20:49:00+0000,2021-03-09 05:12:00+0000,0,,503
2021-03-10,169,337,46,2021-03-09 21:31:00+0000,2021-03-10 06:43:00+0000,0,,506
2021-03-11,159,326,0,2021-03-10 21:32:00+0000,2021-03-11 05:37:00+0000,0,,485
2021-03-12,150,345,2,2021-03-11 21:18:00+0000,2021-03-12 05:35:00+0000,0,,495
2021-03-13,154,364,0,2021-03-12 21:27:00+0000,2021-03-13 06:05:00+0000,0,,518
2021-03-14,126,414,0,2021-03-13 21:25:00+0000,2021-03-14 06:25:00+0000,0,,540
2021-03-15,125,400,0,2021-03-14 21:00:00+0000,2021-03-15 05:45:00+0000,0,,525
2021-03-16,207,334,2,2021-03-15 21:05:00+0000,2021-03-16 06:08:00+0000,0,,541
2021-03-17,141,371,4,2021-03-16 21:28:00+0000,2021-03-17 06:04:00+0000,0,,512
2021-03-18,169,326,2,2021-03-17 21:11:00+0000,2021-03-18 05:28:00+0000,0,,495
2021-03-19,133,382,3,2021-03-18 21:20:00+0000,2021-03-19 05:58:00+0000,0,,515
2021-03-20,140,269,2,2021-03-19 21:13:00+0000,2021-03-20 04:04:00+0000,0,,409
2021-03-21,209,400,0,2021-03-20 20:05:00+0000,2021-03-21 06:14:00+0000,0,,609
2021-03-22,135,353,0,2021-03-21 21:35:00+0000,2021-03-22 05:43:00+0000,0,,488
2021-03-23,90,449,0,2021-03-22 20:55:00+0000,2021-03-23 05:54:00+0000,0,,539
2021-03-24,178,311,0,2021-03-23 21:32:00+0000,2021-03-24 05:41:00+0000,0,,489
2021-03-25,123,401,0,2021-03-24 21:10:00+0000,2021-03-25 05:54:00+0000,0,,524
2021-03-26,172,327,0,2021-03-25 21:46:00+0000,2021-03-26 06:05:00+0000,0,,499
2021-03-27,156,338,0,2021-03-26 21:35:00+0000,2021-03-27 05:49:00+0000,0,,494
2021-03-28,77,432,0,2021-03-27 21:06:00+0000,2021-03-28 05:35:00+0000,0,,509
2021-03-29,144,319,0,2021-03-28 21:28:00+0000,2021-03-29 05:11:00+0000,0,,463
2021-03-30,175,314,0,2021-03-29 21:13:00+0000,2021-03-30 05:22:00+0000,0,,489
2021-03-31,144,392,0,2021-03-30 20:04:00+0000,2021-03-31 05:00:00+0000,0,,536
2021-04-01,172,289,0,2021-03-31 21:08:00+0000,2021-04-01 04:49:00+0000,0,,461
2021-04-02,73,431,0,2021-04-01 20:52:00+0000,2021-04-02 05:16:00+0000,0,,504
2021-04-03,152,428,0,2021-04-02 20:27:00+0000,2021-04-03 06:07:00+0000,0,,580
2021-04-04,187,383,12,2021-04-03 21:19:00+0000,2021-04-04 07:01:00+0000,0,,570
2021-04-05,143,332,27,2021-04-04 21:09:00+0000,2021-04-05 05:31:00+0000,0,,475
2021-04-06,185,346,0,2021-04-05 21:04:00+0000,2021-04-06 05:55:00+0000,0,,531
2021-04-07,153,370,0,2021-04-06 21:05:00+0000,2021-04-07 05:48:00+0000,0,,523
2021-04-08,150,323,0,2021-04-07 21:26:00+0000,2021-04-08 05:19:00+0000,0,,473
2021-04-09,127,271,0,2021-04-08 21:27:00+0000,2021-04-09 04:05:00+0000,0,,398
2021-04-10,105,432,3,2021-04-09 21:42:00+0000,2021-04-10 06:42:00+0000,0,,537
2021-04-11,170,270,0,2021-04-10 21:54:00+0000,2021-04-11 05:14:00+0000,0,,440
2021-04-12,158,213,0,2021-04-11 21:52:00+0000,2021-04-12 04:03:00+0000,0,,371
2021-04-13,251,245,0,2021-04-12 21:44:00+0000,2021-04-13 06:00:00+0000,0,,496
2021-04-14,223,315,0,2021-04-13 20:05:00+0000,2021-04-14 05:03:00+0000,0,,538
2021-04-15,176,386,0,2021-04-14 20:24:00+0000,2021-04-15 05:46:00+0000,0,,562
2021-04-16,245,302,0,2021-04-15 20:22:00+0000,2021-04-16 05:29:00+0000,0,,547
2021-04-17,231,317,0,2021-04-16 20:41:00+0000,2021-04-17 05:49:00+0000,0,,548
2021-04-18,242,323,0,2021-04-17 20:46:00+0000,2021-04-18 06:11:00+0000,0,,565
2021-04-19,183,323,0,2021-04-18 21:06:00+0000,2021-04-19 05:32:00+0000,0,,506
2021-04-20,228,312,0,2021-04-19 21:10:00+0000,2021-04-20 06:10:00+0000,0,,540
2021-04-21,197,257,0,2021-04-20 22:03:00+0000,2021-04-21 05:37:00+0000,0,,454
2021-04-22,172,322,0,2021-04-21 21:34:00+0000,2021-04-22 05:48:00+0000,0,,494
2021-04-23,208,347,0,2021-04-22 21:25:00+0000,2021-04-23 06:40:00+0000,0,,555
2021-04-24,130,129,0,2021-04-23 21:41:00+0000,2021-04-24 02:00:00+0000,0,,259
2021-04-25,78,197,0,2021-04-25 02:14:00+0000,2021-04-25 06:49:00+0000,0,,275
2021-04-26,73,161,0,2021-04-26 01:48:00+0000,2021-04-26 05:42:00+0000,0,,234
2021-04-27,308,273,0,2021-04-26 21:00:00+0000,2021-04-27 06:41:00+0000,0,,581
2021-04-28,190,314,0,2021-04-27 20:46:00+0000,2021-04-28 05:10:00+0000,0,,504
2021-04-29,222,300,0,2021-04-28 21:18:00+0000,2021-04-29 06:00:00+0000,0,,522
2021-04-30,25,224,0,2021-04-30 01:36:00+0000,2021-04-30 05:45:00+0000,0,,249
2021-05-01,282,337,0,2021-04-30 20:33:00+0000,2021-05-01 06:52:00+0000,0,,619
2021-05-02,210,310,0,2021-05-01 21:33:00+0000,2021-05-02 06:13:00+0000,0,,520
2021-05-03,273,228,0,2021-05-02 21:26:00+0000,2021-05-03 05:47:00+0000,0,,501
2021-05-04,211,272,2,2021-05-03 21:29:00+0000,2021-05-04 05:34:00+0000,0,,483
2021-05-05,180,347,0,2021-05-04 20:56:00+0000,2021-05-05 05:43:00+0000,0,,527
2021-05-06,242,272,0,2021-05-05 20:59:00+0000,2021-05-06 05:33:00+0000,0,,514
2021-05-07,231,279,0,2021-05-06 21:08:00+0000,2021-05-07 05:38:00+0000,0,,510
2021-05-08,201,283,0,2021-05-07 21:33:00+0000,2021-05-08 05:37:00+0000,0,,484
2021-05-09,247,369,0,2021-05-08 20:52:00+0000,2021-05-09 07:08:00+0000,0,,616
2021-05-10,65,174,0,2021-05-10 01:31:00+0000,2021-05-10 05:30:00+0000,0,,239
2021-05-11,42,225,0,2021-05-11 01:38:00+0000,2021-05-11 06:05:00+0000,0,,267
2021-05-12,71,191,0,2021-05-12 01:32:00+0000,2021-05-12 05:54:00+0000,0,,262
2021-05-13,123,333,0,2021-05-12 21:25:00+0000,2021-05-13 05:01:00+0000,0,,456
2021-05-14,125,264,0,2021-05-13 22:56:00+0000,2021-05-14 05:25:00+0000,0,,389
2021-05-15,167,288,0,2021-05-14 21:27:00+0000,2021-05-15 05:02:00+0000,0,,455
2021-05-16,161,351,0,2021-05-15 21:35:00+0000,2021-05-16 06:07:00+0000,0,,512
2021-05-17,112,337,0,2021-05-16 22:18:00+0000,2021-05-17 05:47:00+0000,0,,449
2021-05-18,216,310,0,2021-05-17 21:09:00+0000,2021-05-18 05:55:00+0000,0,,526
2021-05-19,181,314,2,2021-05-18 21:00:00+0000,2021-05-19 05:17:00+0000,0,,495
2021-05-20,146,383,0,2021-05-19 20:25:00+0000,2021-05-20 05:14:00+0000,0,,529
2021-05-21,166,417,46,2021-05-20 19:01:00+0000,2021-05-21 05:30:00+0000,0,,583
2021-05-22,208,308,16,2021-05-21 20:33:00+0000,2021-05-22 05:25:00+0000,0,,516
2021-05-23,144,446,4,2021-05-22 19:59:00+0000,2021-05-23 05:53:00+0000,0,,590
2021-05-24,94,346,46,2021-05-23 20:34:00+0000,2021-05-24 04:40:00+0000,0,,440
2021-05-25,181,419,0,2021-05-24 19:13:00+0000,2021-05-25 05:13:00+0000,0,,600
2021-05-26,196,398,2,2021-05-25 18:42:00+0000,2021-05-26 04:38:00+0000,0,,594
2021-05-27,175,317,0,2021-05-26 21:31:00+0000,2021-05-27 05:43:00+0000,0,,492
2021-05-28,111,345,0,2021-05-27 21:55:00+0000,2021-05-28 05:31:00+0000,0,,456
2021-05-29,102,442,0,2021-05-28 20:30:00+0000,2021-05-29 05:34:00+0000,0,,544
2021-05-30,63,337,24,2021-05-29 21:15:00+0000,2021-05-30 04:19:00+0000,0,,400
2021-05-31,153,345,0,2021-05-30 20:30:00+0000,2021-05-31 04:48:00+0000,0,,498
2021-06-01,187,475,0,2021-05-31 18:12:00+0000,2021-06-01 05:14:00+0000,0,,662
2021-06-02,166,320,0,2021-06-01 21:30:00+0000,2021-06-02 05:36:00+0000,0,,486
2021-06-03,129,386,2,2021-06-02 20:19:00+0000,2021-06-03 04:56:00+0000,0,,515
2021-06-04,157,338,62,2021-06-03 19:38:00+0000,2021-06-04 04:55:00+0000,0,,495
2021-06-05,148,277,0,2021-06-04 21:51:00+0000,2021-06-05 04:56:00+0000,0,,425
2021-06-06,184,372,0,2021-06-05 20:18:00+0000,2021-06-06 05:34:00+0000,0,,556
2021-06-07,108,224,0,2021-06-06 19:55:00+0000,2021-06-07 01:27:00+0000,0,,332
2021-06-08,170,327,0,2021-06-07 20:10:00+0000,2021-06-08 04:27:00+0000,0,,497
2021-06-09,73,178,0,2021-06-09 01:27:00+0000,2021-06-09 05:38:00+0000,0,,251
2021-06-10,152,349,0,2021-06-09 21:14:00+0000,2021-06-10 05:35:00+0000,0,,501
2021-06-11,153,331,3,2021-06-10 21:18:00+0000,2021-06-11 05:25:00+0000,0,,484
2021-06-12,192,309,0,2021-06-11 21:16:00+0000,2021-06-12 05:37:00+0000,0,,501
2021-06-13,98,438,0,2021-06-12 20:19:00+0000,2021-06-13 05:15:00+0000,0,,536
2021-06-14,103,403,0,2021-06-13 20:51:00+0000,2021-06-14 05:17:00+0000,0,,506
2021-06-15,176,324,3,2021-06-14 20:43:00+0000,2021-06-15 05:06:00+0000,0,,500
2021-06-16,157,316,0,2021-06-15 21:28:00+0000,2021-06-16 05:21:00+0000,0,,473
2021-06-17,177,379,0,2021-06-16 20:46:00+0000,2021-06-17 06:02:00+0000,0,,556
2021-06-18,189,281,0,2021-06-17 21:07:00+0000,2021-06-18 04:57:00+0000,0,,470
2021-06-19,146,312,0,2021-06-18 21:03:00+0000,2021-06-19 04:41:00+0000,0,,458
2021-06-20,160,374,0,2021-06-19 20:01:00+0000,2021-06-20 04:55:00+0000,0,,534
2021-06-21,173,300,0,2021-06-20 21:14:00+0000,2021-06-21 05:07:00+0000,0,,473
2021-06-22,110,408,0,2021-06-21 20:38:00+0000,2021-06-22 05:16:00+0000,0,,518
2021-06-23,133,382,0,2021-06-22 21:07:00+0000,2021-06-23 05:42:00+0000,0,,515
2021-06-24,83,413,0,2021-06-23 21:06:00+0000,2021-06-24 05:22:00+0000,0,,496
2021-06-25,106,300,0,2021-06-24 21:36:00+0000,2021-06-25 04:22:00+0000,0,,406
2021-06-26,161,229,0,2021-06-25 23:27:00+0000,2021-06-26 05:57:00+0000,0,,390
2021-06-27,197,320,4,2021-06-26 21:06:00+0000,2021-06-27 05:47:00+0000,0,,517
2021-06-28,145,289,0,2021-06-27 21:53:00+0000,2021-06-28 05:07:00+0000,0,,434
2021-06-29,135,319,11,2021-06-28 21:33:00+0000,2021-06-29 05:18:00+0000,0,,454
2021-06-30,138,362,0,2021-06-29 21:36:00+0000,2021-06-30 05:56:00+0000,0,,500
2021-07-01,114,386,0,2021-06-30 21:14:00+0000,2021-07-01 05:34:00+0000,0,,500
2021-07-02,231,366,2,2021-07-01 19:06:00+0000,2021-07-02 05:05:00+0000,0,,597
2021-07-03,157,364,0,2021-07-02 20:40:00+0000,2021-07-03 05:21:00+0000,0,,521
2021-07-04,136,395,0,2021-07-03 20:57:00+0000,2021-07-04 05:48:00+0000,0,,531
2021-07-05,155,384,0,2021-07-04 20:39:00+0000,2021-07-05 05:38:00+0000,0,,539
2021-07-06,240,254,0,2021-07-05 20:19:00+0000,2021-07-06 04:33:00+0000,0,,494
2021-07-07,164,343,0,2021-07-06 20:41:00+0000,2021-07-07 05:08:00+0000,0,,507
2021-07-08,184,257,0,2021-07-07 21:28:00+0000,2021-07-08 04:49:00+0000,0,,441
2021-07-09,126,351,0,2021-07-08 20:44:00+0000,2021-07-09 04:41:00+0000,0,,477
2021-07-10,115,487,34,2021-07-09 18:36:00+0000,2021-07-10 05:12:00+0000,0,,602
2021-07-11,160,362,0,2021-07-10 20:33:00+0000,2021-07-11 05:15:00+0000,0,,522
2021-07-12,192,316,0,2021-07-11 20:53:00+0000,2021-07-12 05:21:00+0000,0,,508
2021-07-13,166,341,0,2021-07-12 20:32:00+0000,2021-07-13 04:59:00+0000,0,,507
2021-07-14,153,329,12,2021-07-13 20:54:00+0000,2021-07-14 05:08:00+0000,0,,482
2021-07-15,195,265,0,2021-07-14 21:40:00+0000,2021-07-15 05:20:00+0000,0,,460
2021-07-16,143,399,0,2021-07-15 20:39:00+0000,2021-07-16 05:41:00+0000,0,,542
2021-07-17,133,432,21,2021-07-16 20:01:00+0000,2021-07-17 05:47:00+0000,0,,565
2021-07-18,143,358,0,2021-07-17 20:42:00+0000,2021-07-18 05:03:00+0000,0,,501
2021-07-19,172,353,0,2021-07-18 20:12:00+0000,2021-07-19 04:57:00+0000,0,,525
2021-07-20,116,359,2,2021-07-19 18:51:00+0000,2021-07-20 02:48:00+0000,0,,475
2021-07-21,206,278,3,2021-07-20 21:39:00+0000,2021-07-21 05:46:00+0000,0,,484
2021-07-22,113,370,0,2021-07-21 21:12:00+0000,2021-07-22 05:15:00+0000,0,,483
2021-07-23,185,259,2,2021-07-22 21:12:00+0000,2021-07-23 04:38:00+0000,0,,444
2021-07-24,173,373,0,2021-07-23 20:36:00+0000,2021-07-24 05:42:00+0000,0,,546
2021-07-25,115,346,2,2021-07-24 22:00:00+0000,2021-07-25 05:43:00+0000,0,,461
2021-07-26,199,379,0,2021-07-25 20:15:00+0000,2021-07-26 05:53:00+0000,0,,578
2021-07-27,187,289,0,2021-07-26 21:05:00+0000,2021-07-27 05:01:00+0000,0,,476
2021-07-28,124,369,0,2021-07-27 20:57:00+0000,2021-07-28 05:10:00+0000,0,,493
2021-07-29,205,320,0,2021-07-28 20:01:00+0000,2021-07-29 04:46:00+0000,0,,525
2021-07-30,216,327,0,2021-07-29 20:22:00+0000,2021-07-30 05:25:00+0000,0,,543
2021-07-31,166,368,25,2021-07-30 19:57:00+0000,2021-07-31 05:16:00+0000,0,,534
2021-08-01,181,341,0,2021-07-31 21:02:00+0000,2021-08-01 05:44:00+0000,0,,522
2021-08-02,136,320,0,2021-08-01 21:39:00+0000,2021-08-02 05:15:00+0000,0,,456
2021-08-03,162,372,0,2021-08-02 20:32:00+0000,2021-08-03 05:26:00+0000,0,,534
2021-08-04,122,373,0,2021-08-03 21:08:00+0000,2021-08-04 05:23:00+0000,0,,495
2021-08-05,188,352,0,2021-08-04 20:55:00+0000,2021-08-05 05:55:00+0000,0,,540
2021-08-06,129,365,0,2021-08-05 21:12:00+0000,2021-08-06 05:26:00+0000,0,,494
2021-08-07,141,329,2,2021-08-06 21:28:00+0000,2021-08-07 05:20:00+0000,0,,470
2021-08-08,202,454,0,2021-08-07 18:45:00+0000,2021-08-08 05:41:00+0000,0,,656
2021-08-09,230,336,0,2021-08-08 20:19:00+0000,2021-08-09 05:45:00+0000,0,,566
2021-08-10,106,235,0,2021-08-09 20:17:00+0000,2021-08-10 01:58:00+0000,0,,341
2021-08-11,173,397,0,2021-08-10 20:17:00+0000,2021-08-11 05:47:00+0000,0,,570
2021-08-12,214,263,0,2021-08-11 21:38:00+0000,2021-08-12 05:35:00+0000,0,,477
2021-08-13,207,392,15,2021-08-12 19:28:00+0000,2021-08-13 05:42:00+0000,0,,599
2021-08-14,209,272,0,2021-08-13 21:48:00+0000,2021-08-14 05:49:00+0000,0,,481
2021-08-15,170,380,0,2021-08-14 20:50:00+0000,2021-08-15 06:00:00+0000,0,,550
2021-08-16,169,293,73,2021-08-15 21:21:00+0000,2021-08-16 06:16:00+0000,0,,462
2021-08-17,210,330,0,2021-08-16 20:56:00+0000,2021-08-17 05:56:00+0000,0,,540
2021-08-18,171,460,29,2021-08-17 18:47:00+0000,2021-08-18 05:47:00+0000,0,,631
2021-08-19,186,324,0,2021-08-18 20:36:00+0000,2021-08-19 05:06:00+0000,0,,510
2021-08-20,163,305,0,2021-08-19 21:45:00+0000,2021-08-20 05:33:00+0000,0,,468
2021-08-21,207,370,0,2021-08-20 20:10:00+0000,2021-08-21 05:47:00+0000,0,,577
2021-08-22,164,384,0,2021-08-21 20:05:00+0000,2021-08-22 05:13:00+0000,0,,548
2021-08-23,234,324,0,2021-08-22 20:12:00+0000,2021-08-23 05:30:00+0000,0,,558
2021-08-24,175,363,2,2021-08-23 21:00:00+0000,2021-08-24 06:00:00+0000,0,,538
2021-08-25,185,255,0,2021-08-24 22:35:00+0000,2021-08-25 05:55:00+0000,0,,440
2021-08-26,149,381,3,2021-08-25 20:24:00+0000,2021-08-26 05:17:00+0000,0,,530
2021-08-27,134,385,0,2021-08-26 20:55:00+0000,2021-08-27 05:34:00+0000,0,,519
2021-08-28,173,411,0,2021-08-27 19:58:00+0000,2021-08-28 05:42:00+0000,0,,584
2021-08-29,134,423,0,2021-08-28 20:22:00+0000,2021-08-29 05:39:00+0000,0,,557
2021-08-30,138,394,0,2021-08-29 20:35:00+0000,2021-08-30 05:27:00+0000,0,,532
2021-08-31,206,419,0,2021-08-30 19:09:00+0000,2021-08-31 05:34:00+0000,0,,625
2021-09-01,192,354,0,2021-08-31 20:29:00+0000,2021-09-01 05:35:00+0000,0,,546
2021-09-02,138,361,2,2021-09-01 21:23:00+0000,2021-09-02 05:44:00+0000,0,,499
2021-09-03,134,432,0,2021-09-02 20:31:00+0000,2021-09-03 05:57:00+0000,0,,566
2021-09-04,156,371,0,2021-09-03 20:55:00+0000,2021-09-04 05:42:00+0000,0,,527
2021-09-05,122,381,2,2021-09-04 20:29:00+0000,2021-09-05 04:54:00+0000,0,,503
2021-09-06,187,387,0,2021-09-05 19:57:00+0000,2021-09-06 05:31:00+0000,0,,574
2021-09-07,154,411,21,2021-09-06 19:42:00+0000,2021-09-07 05:28:00+0000,0,,565
2021-09-08,120,369,0,2021-09-07 21:03:00+0000,2021-09-08 05:12:00+0000,0,,489
2021-09-09,123,478,0,2021-09-08 19:43:00+0000,2021-09-09 05:44:00+0000,0,,601
2021-09-10,144,458,0,2021-09-09 19:25:00+0000,2021-09-10 05:27:00+0000,0,,602
2021-09-11,183,362,0,2021-09-10 20:13:00+0000,2021-09-11 05:18:00+0000,0,,545
2021-09-12,121,441,0,2021-09-11 19:45:00+0000,2021-09-12 05:07:00+0000,0,,562
2021-09-13,139,397,0,2021-09-12 20:46:00+0000,2021-09-13 05:42:00+0000,0,,536
2021-09-14,94,430,0,2021-09-13 20:27:00+0000,2021-09-14 05:11:00+0000,0,,524
2021-09-15,149,242,2,2021-09-14 20:29:00+0000,2021-09-15 03:02:00+0000,0,,391
2021-09-16,95,390,2,2021-09-15 20:40:00+0000,2021-09-16 04:47:00+0000,0,,485
2021-09-17,151,332,0,2021-09-16 21:20:00+0000,2021-09-17 05:23:00+0000,0,,483
2021-09-18,157,408,2,2021-09-17 20:10:00+0000,2021-09-18 05:37:00+0000,0,,565
2021-09-19,92,422,5,2021-09-18 20:35:00+0000,2021-09-19 05:14:00+0000,0,,514
2021-09-20,140,404,0,2021-09-19 19:39:00+0000,2021-09-20 04:43:00+0000,0,,544
2021-09-21,0,0,0,2021-09-19 21:00:00+0000,2021-09-19 21:00:00+0000,0,,0
2021-09-22,178,297,18,2021-09-21 20:47:00+0000,2021-09-22 05:00:00+0000,0,,475
2021-09-23,110,355,0,2021-09-22 21:52:00+0000,2021-09-23 05:37:00+0000,0,,465
2021-09-24,0,0,0,2021-09-22 21:00:00+0000,2021-09-22 21:00:00+0000,0,,0
2021-09-25,109,277,2,2021-09-24 22:27:00+0000,2021-09-25 04:55:00+0000,0,,386
2021-09-26,129,302,0,2021-09-25 19:50:00+0000,2021-09-26 03:01:00+0000,0,,431
2021-09-27,26,76,0,2021-09-26 20:00:00+0000,2021-09-26 21:42:00+0000,0,,102
2021-09-28,131,260,0,2021-09-27 21:12:00+0000,2021-09-28 03:43:00+0000,0,,391
2021-09-29,217,299,2,2021-09-28 20:51:00+0000,2021-09-29 05:29:00+0000,0,,516
2021-09-30,119,402,40,2021-09-29 21:00:00+0000,2021-09-30 06:21:00+0000,0,,521
2021-10-01,176,296,0,2021-09-30 21:16:00+0000,2021-10-01 05:08:00+0000,0,,472
2021-10-02,249,325,0,2021-10-01 21:05:00+0000,2021-10-02 06:39:00+0000,0,,574
2021-10-03,120,392,2,2021-10-02 21:24:00+0000,2021-10-03 05:58:00+0000,0,,512
2021-10-04,178,358,0,2021-10-03 21:07:00+0000,2021-10-04 06:03:00+0000,0,,536
2021-10-05,132,319,0,2021-10-04 21:31:00+0000,2021-10-05 05:02:00+0000,0,,451
2021-10-06,172,346,0,2021-10-05 21:03:00+0000,2021-10-06 05:41:00+0000,0,,518
2021-10-07,149,365,0,2021-10-06 21:14:00+0000,2021-10-07 05:48:00+0000,0,,514
2021-10-08,156,309,0,2021-10-07 21:14:00+0000,2021-10-08 04:59:00+0000,0,,465
2021-10-09,201,360,13,2021-10-08 21:02:00+0000,2021-10-09 06:36:00+0000,0,,561
2021-10-10,129,338,0,2021-10-09 23:17:00+0000,2021-10-10 07:04:00+0000,0,,467
2021-10-11,111,328,36,2021-10-10 21:29:00+0000,2021-10-11 05:24:00+0000,0,,439
2021-10-12,113,376,0,2021-10-11 21:15:00+0000,2021-10-12 05:24:00+0000,0,,489
2021-10-13,117,277,0,2021-10-12 20:55:00+0000,2021-10-13 03:29:00+0000,0,,394
2021-10-14,109,281,0,2021-10-13 20:51:00+0000,2021-10-14 03:21:00+0000,0,,390
2021-10-15,167,268,0,2021-10-14 21:51:00+0000,2021-10-15 05:06:00+0000,0,,435
2021-10-16,251,364,0,2021-10-15 20:44:00+0000,2021-10-16 06:59:00+0000,0,,615
2021-10-17,211,362,0,2021-10-16 21:42:00+0000,2021-10-17 07:15:00+0000,0,,573
2021-10-18,196,310,0,2021-10-17 21:30:00+0000,2021-10-18 05:56:00+0000,0,,506
2021-10-19,246,373,0,2021-10-18 19:54:00+0000,2021-10-19 06:13:00+0000,0,,619
2021-10-20,203,272,0,2021-10-19 22:06:00+0000,2021-10-20 06:01:00+0000,0,,475
2021-10-21,117,374,0,2021-10-20 20:48:00+0000,2021-10-21 04:59:00+0000,0,,491
2021-10-22,161,321,0,2021-10-21 21:09:00+0000,2021-10-22 05:11:00+0000,0,,482
2021-10-23,124,431,0,2021-10-22 21:42:00+0000,2021-10-23 06:57:00+0000,0,,555
2021-10-24,183,185,0,2021-10-24 00:06:00+0000,2021-10-24 06:14:00+0000,0,,368
2021-10-25,230,296,0,2021-10-24 20:32:00+0000,2021-10-25 05:18:00+0000,0,,526
2021-10-26,203,256,0,2021-10-25 21:36:00+0000,2021-10-26 05:15:00+0000,0,,459
2021-10-27,136,360,0,2021-10-26 21:40:00+0000,2021-10-27 05:56:00+0000,0,,496
2021-10-28,216,370,0,2021-10-27 20:36:00+0000,2021-10-28 06:22:00+0000,0,,586
2021-10-29,178,403,0,2021-10-28 20:42:00+0000,2021-10-29 06:23:00+0000,0,,581
2021-10-30,191,349,0,2021-10-29 21:10:00+0000,2021-10-30 06:10:00+0000,0,,540
2021-10-31,222,330,0,2021-10-30 20:46:00+0000,2021-10-31 05:58:00+0000,0,,552
2021-11-01,73,177,0,2021-10-31 21:08:00+0000,2021-11-01 01:18:00+0000,0,,250
2021-11-02,145,376,0,2021-11-01 20:48:00+0000,2021-11-02 05:29:00+0000,0,,521
2021-11-03,108,223,0,2021-11-02 21:49:00+0000,2021-11-03 03:20:00+0000,0,,331
2021-11-04,160,351,0,2021-11-03 21:19:00+0000,2021-11-04 05:50:00+0000,0,,511
2021-11-05,121,364,0,2021-11-04 21:19:00+0000,2021-11-05 05:24:00+0000,0,,485
2021-11-06,178,438,16,2021-11-05 20:11:00+0000,2021-11-06 06:43:00+0000,0,,616
2021-11-07,197,541,0,2021-11-06 19:42:00+0000,2021-11-07 08:00:00+0000,0,,738
2021-11-08,169,353,0,2021-11-07 21:25:00+0000,2021-11-08 06:07:00+0000,0,,522
2021-11-09,93,305,0,2021-11-08 21:23:00+0000,2021-11-09 04:01:00+0000,0,,398
2021-11-10,154,452,2,2021-11-09 20:47:00+0000,2021-11-10 06:55:00+0000,0,,606
2021-11-11,158,292,0,2021-11-10 21:42:00+0000,2021-11-11 05:12:00+0000,0,,450
2021-11-12,167,302,0,2021-11-11 21:24:00+0000,2021-11-12 05:13:00+0000,0,,469
2021-11-13,148,219,0,2021-11-12 21:25:00+0000,2021-11-13 03:32:00+0000,0,,367
2021-11-14,209,401,0,2021-11-13 21:38:00+0000,2021-11-14 07:48:00+0000,0,,610
2021-11-15,124,513,0,2021-11-14 20:44:00+0000,2021-11-15 07:21:00+0000,0,,637
2021-11-16,94,369,22,2021-11-15 21:28:00+0000,2021-11-16 05:33:00+0000,0,,463
2021-11-17,150,414,14,2021-11-16 20:44:00+0000,2021-11-17 06:22:00+0000,0,,564
2021-11-18,110,298,0,2021-11-17 21:20:00+0000,2021-11-18 04:08:00+0000,0,,408
2021-11-19,158,345,0,2021-11-18 21:11:00+0000,2021-11-19 05:34:00+0000,0,,503
2021-11-20,215,287,0,2021-11-19 21:22:00+0000,2021-11-20 05:44:00+0000,0,,502
2021-11-21,118,250,0,2021-11-20 21:52:00+0000,2021-11-21 04:00:00+0000,0,,368
2021-11-22,144,422,2,2021-11-21 21:50:00+0000,2021-11-22 07:18:00+0000,0,,566
2021-11-23,63,341,0,2021-11-22 21:30:00+0000,2021-11-23 04:14:00+0000,0,,404
2021-11-24,211,371,0,2021-11-23 21:32:00+0000,2021-11-24 07:14:00+0000,0,,582
2021-11-25,150,398,31,2021-11-24 21:12:00+0000,2021-11-25 06:51:00+0000,0,,548
2021-11-26,114,345,0,2021-11-25 21:53:00+0000,2021-11-26 05:32:00+0000,0,,459
2021-11-27,154,293,2,2021-11-26 20:40:00+0000,2021-11-27 04:09:00+0000,0,,447
2021-11-28,153,404,27,2021-11-27 21:19:00+0000,2021-11-28 07:03:00+0000,0,,557
2021-11-29,148,370,2,2021-11-28 21:48:00+0000,2021-11-29 06:28:00+0000,0,,518
2021-11-30,172,403,2,2021-11-29 21:02:00+0000,2021-11-30 06:39:00+0000,0,,575
2021-12-01,211,347,0,2021-11-30 21:33:00+0000,2021-12-01 06:51:00+0000,0,,558
2021-12-02,97,334,17,2021-12-01 22:28:00+0000,2021-12-02 05:56:00+0000,0,,431
2021-12-03,64,314,0,2021-12-02 22:09:00+0000,2021-12-03 04:27:00+0000,0,,378
2021-12-04,144,270,0,2021-12-03 21:09:00+0000,2021-12-04 04:03:00+0000,0,,414
2021-12-05,200,368,0,2021-12-04 22:07:00+0000,2021-12-05 07:35:00+0000,0,,568
2021-12-06,122,411,0,2021-12-05 21:26:00+0000,2021-12-06 06:19:00+0000,0,,533
2021-12-07,189,279,3,2021-12-06 20:44:00+0000,2021-12-07 04:35:00+0000,0,,468
2021-12-08,162,383,2,2021-12-07 22:03:00+0000,2021-12-08 07:10:00+0000,0,,545
2021-12-09,181,264,0,2021-12-08 21:24:00+0000,2021-12-09 04:49:00+0000,0,,445
2021-12-10,101,322,0,2021-12-09 22:12:00+0000,2021-12-10 05:15:00+0000,0,,423
2021-12-11,136,337,0,2021-12-10 20:42:00+0000,2021-12-11 04:35:00+0000,0,,473
2021-12-12,124,484,22,2021-12-11 21:51:00+0000,2021-12-12 08:21:00+0000,0,,608
2021-12-13,95,342,0,2021-12-12 21:33:00+0000,2021-12-13 04:50:00+0000,0,,437
2021-12-14,120,343,0,2021-12-13 21:04:00+0000,2021-12-14 04:47:00+0000,0,,463
2021-12-15,131,336,0,2021-12-14 20:57:00+0000,2021-12-15 04:44:00+0000,0,,467
2021-12-16,95,346,0,2021-12-15 21:30:00+0000,2021-12-16 04:51:00+0000,0,,441
2021-12-17,149,284,0,2021-12-16 21:47:00+0000,2021-12-17 05:00:00+0000,0,,433
2021-12-18,129,416,16,2021-12-17 21:41:00+0000,2021-12-18 07:02:00+0000,0,,545
2021-12-19,113,278,0,2021-12-18 22:21:00+0000,2021-12-19 04:52:00+0000,0,,391
2021-12-20,152,400,28,2021-12-19 22:00:00+0000,2021-12-20 07:40:00+0000,0,,552
2021-12-21,113,355,15,2021-12-20 22:11:00+0000,2021-12-21 06:14:00+0000,0,,468
2021-12-22,155,357,15,2021-12-21 21:46:00+0000,2021-12-22 06:33:00+0000,0,,512
2021-12-23,143,283,3,2021-12-22 21:48:00+0000,2021-12-23 04:57:00+0000,0,,426
2021-12-24,139,321,0,2021-12-23 21:24:00+0000,2021-12-24 05:04:00+0000,0,,460
2021-12-25,210,486,0,2021-12-24 19:38:00+0000,2021-12-25 07:14:00+0000,0,,696
2021-12-26,131,486,16,2021-12-25 20:55:00+0000,2021-12-26 07:28:00+0000,0,,617
2021-12-27,144,409,26,2021-12-26 21:23:00+0000,2021-12-27 07:02:00+0000,0,,553
2021-12-28,104,323,0,2021-12-27 21:28:00+0000,2021-12-28 04:35:00+0000,0,,427
2021-12-29,121,428,17,2021-12-28 21:59:00+0000,2021-12-29 07:25:00+0000,0,,549
2021-12-30,131,309,0,2021-12-29 21:23:00+0000,2021-12-30 04:43:00+0000,0,,440
2021-12-31,116,381,20,2021-12-30 21:49:00+0000,2021-12-31 06:26:00+0000,0,,497
2022-01-01,125,229,0,2021-12-31 22:06:00+0000,2022-01-01 04:00:00+0000,0,,354
2022-01-02,156,350,33,2022-01-01 21:35:00+0000,2022-01-02 06:34:00+0000,0,,506
2022-01-03,130,398,27,2022-01-02 20:53:00+0000,2022-01-03 06:08:00+0000,0,,528
2022-01-04,146,425,26,2022-01-03 20:32:00+0000,2022-01-04 06:29:00+0000,0,,571
2022-01-05,176,335,0,2022-01-04 22:06:00+0000,2022-01-05 06:37:00+0000,0,,511
2022-01-06,154,344,21,2022-01-05 21:03:00+0000,2022-01-06 05:42:00+0000,0,,498
2022-01-07,97,449,21,2022-01-06 20:50:00+0000,2022-01-07 06:17:00+0000,0,,546
2022-01-08,179,332,3,2022-01-07 21:40:00+0000,2022-01-08 06:14:00+0000,0,,511
2022-02-02,107,398,12,2022-02-01 21:16:00+0000,2022-02-02 05:53:00+0000,0,,505
2022-02-03,108,417,13,2022-02-02 21:21:00+0000,2022-02-03 06:19:00+0000,0,,525
2022-02-04,198,373,2,2022-02-03 20:33:00+0000,2022-02-04 06:06:00+0000,0,,571
2022-02-05,29,474,26,2022-02-04 21:11:00+0000,2022-02-05 06:00:00+0000,0,,503
2022-02-06,152,352,2,2022-02-05 21:55:00+0000,2022-02-06 06:21:00+0000,0,,504
2022-02-07,134,462,0,2022-02-06 20:48:00+0000,2022-02-07 06:44:00+0000,0,,596
2022-02-08,133,407,0,2022-02-07 21:37:00+0000,2022-02-08 06:37:00+0000,0,,540
2022-02-09,155,387,0,2022-02-08 21:13:00+0000,2022-02-09 06:15:00+0000,0,,542
2022-02-10,121,372,0,2022-02-09 22:07:00+0000,2022-02-10 06:20:00+0000,0,,493
2022-02-11,0,0,0,2022-02-09 21:00:00+0000,2022-02-09 21:00:00+0000,0,,0
2022-02-12,203,260,0,2022-02-11 22:18:00+0000,2022-02-12 06:01:00+0000,0,,463
2022-02-13,183,327,3,2022-02-12 22:19:00+0000,2022-02-13 06:52:00+0000,0,,510
2022-02-14,97,249,0,2022-02-13 21:56:00+0000,2022-02-14 03:42:00+0000,0,,346
2022-02-15,117,413,0,2022-02-14 21:50:00+0000,2022-02-15 06:40:00+0000,0,,530
2022-02-16,57,252,0,2022-02-15 22:26:00+0000,2022-02-16 03:35:00+0000,0,,309
2022-02-17,115,270,0,2022-02-16 21:13:00+0000,2022-02-17 03:38:00+0000,0,,385
2022-02-18,103,350,0,2022-02-17 22:17:00+0000,2022-02-18 05:50:00+0000,0,,453
2022-02-19,103,416,12,2022-02-18 21:14:00+0000,2022-02-19 06:05:00+0000,0,,519
2022-02-20,128,426,25,2022-02-19 21:06:00+0000,2022-02-20 06:45:00+0000,0,,554
2022-02-21,95,440,21,2022-02-20 21:19:00+0000,2022-02-21 06:35:00+0000,0,,535
2022-02-22,59,476,18,2022-02-21 21:13:00+0000,2022-02-22 06:26:00+0000,0,,535
2022-02-23,75,253,14,2022-02-22 21:12:00+0000,2022-02-23 02:54:00+0000,0,,328
2022-02-24,115,382,56,2022-02-23 21:14:00+0000,2022-02-24 06:27:00+0000,0,,497
2022-02-25,131,371,14,2022-02-24 21:48:00+0000,2022-02-25 06:24:00+0000,0,,502
2022-02-26,131,372,22,2022-02-25 21:07:00+0000,2022-02-26 05:52:00+0000,0,,503
2022-02-27,97,389,24,2022-02-26 21:29:00+0000,2022-02-27 05:59:00+0000,0,,486
2022-02-28,121,381,29,2022-02-27 20:59:00+0000,2022-02-28 05:50:00+0000,0,,502
2022-03-01,109,369,21,2022-02-28 21:40:00+0000,2022-03-01 05:59:00+0000,0,,478
2022-03-02,176,326,0,2022-03-01 21:55:00+0000,2022-03-02 06:17:00+0000,0,,502
2022-03-03,57,249,0,2022-03-02 22:11:00+0000,2022-03-03 03:17:00+0000,0,,306
2022-03-04,139,309,26,2022-03-03 22:08:00+0000,2022-03-04 06:02:00+0000,0,,448
2022-03-05,106,360,28,2022-03-04 21:53:00+0000,2022-03-05 06:07:00+0000,0,,466
2022-03-06,137,373,33,2022-03-05 21:00:00+0000,2022-03-06 06:03:00+0000,0,,510
2022-03-07,165,331,2,2022-03-06 21:46:00+0000,2022-03-07 06:04:00+0000,0,,496
2022-03-08,129,304,2,2022-03-07 22:19:00+0000,2022-03-08 05:34:00+0000,0,,433
2022-03-09,55,244,0,2022-03-08 22:10:00+0000,2022-03-09 03:09:00+0000,0,,299
2022-03-10,180,292,0,2022-03-09 22:55:00+0000,2022-03-10 06:47:00+0000,0,,472
2022-03-11,115,353,14,2022-03-10 22:12:00+0000,2022-03-11 06:14:00+0000,0,,468
2022-03-12,158,325,0,2022-03-11 22:05:00+0000,2022-03-12 06:08:00+0000,0,,483
2022-03-13,133,322,0,2022-03-12 22:57:00+0000,2022-03-13 06:32:00+0000,0,,455
2022-03-14,180,263,0,2022-03-13 22:53:00+0000,2022-03-14 06:16:00+0000,0,,443
2022-03-15,101,347,0,2022-03-14 21:41:00+0000,2022-03-15 05:09:00+0000,0,,448
2022-03-16,239,320,4,2022-03-15 19:56:00+0000,2022-03-16 05:19:00+0000,0,,559
2022-03-17,125,352,0,2022-03-16 21:27:00+0000,2022-03-17 05:24:00+0000,0,,477
2022-03-18,187,323,23,2022-03-17 20:31:00+0000,2022-03-18 05:24:00+0000,0,,510
2022-03-19,146,294,0,2022-03-18 22:16:00+0000,2022-03-19 05:36:00+0000,0,,440
2022-03-20,121,373,25,2022-03-19 21:12:00+0000,2022-03-20 05:51:00+0000,0,,494
2022-03-21,94,259,0,2022-03-20 20:55:00+0000,2022-03-21 02:48:00+0000,0,,353
2022-03-22,65,270,0,2022-03-21 20:45:00+0000,2022-03-22 02:20:00+0000,0,,335
2022-03-23,171,446,28,2022-03-22 19:19:00+0000,2022-03-23 06:04:00+0000,0,,617
2022-03-24,97,320,21,2022-03-23 22:03:00+0000,2022-03-24 05:21:00+0000,0,,417
2022-03-25,108,346,22,2022-03-24 21:45:00+0000,2022-03-25 05:41:00+0000,0,,454
2022-03-26,157,396,28,2022-03-25 21:17:00+0000,2022-03-26 06:58:00+0000,0,,553
2022-03-27,125,429,19,2022-03-26 20:27:00+0000,2022-03-27 06:00:00+0000,0,,554
2022-03-28,96,441,20,2022-03-27 21:29:00+0000,2022-03-28 06:46:00+0000,0,,537
2022-03-29,129,413,20,2022-03-28 21:16:00+0000,2022-03-29 06:38:00+0000,0,,542
2022-03-30,83,407,25,2022-03-29 21:37:00+0000,2022-03-30 06:12:00+0000,0,,490
2022-03-31,92,335,12,2022-03-30 22:10:00+0000,2022-03-31 05:29:00+0000,0,,427
2022-04-01,95,421,14,2022-03-31 21:33:00+0000,2022-04-01 06:23:00+0000,0,,516
2022-04-02,78,129,0,2022-04-01 21:42:00+0000,2022-04-02 01:09:00+0000,0,,207
2022-04-03,49,94,0,2022-04-02 22:58:00+0000,2022-04-03 01:21:00+0000,0,,143
2022-04-04,22,78,0,2022-04-03 23:09:00+0000,2022-04-04 00:49:00+0000,0,,100
2022-04-05,12,121,0,2022-04-04 23:03:00+0000,2022-04-05 01:16:00+0000,0,,133
2022-04-06,61,268,0,2022-04-06 02:58:00+0000,2022-04-06 08:27:00+0000,0,,329
2022-04-07,39,128,0,2022-04-06 22:27:00+0000,2022-04-07 01:14:00+0000,0,,167
2022-04-08,83,196,0,2022-04-08 02:53:00+0000,2022-04-08 07:32:00+0000,0,,279
2022-04-09,95,237,35,2022-04-09 02:57:00+0000,2022-04-09 09:04:00+0000,0,,332
2022-04-10,69,318,0,2022-04-10 02:23:00+0000,2022-04-10 08:50:00+0000,0,,387
2022-04-11,110,308,0,2022-04-11 02:34:00+0000,2022-04-11 09:32:00+0000,0,,418
2022-04-12,109,275,0,2022-04-12 02:31:00+0000,2022-04-12 08:55:00+0000,0,,384
2022-04-13,116,272,0,2022-04-13 02:20:00+0000,2022-04-13 08:48:00+0000,0,,388
2022-04-14,0,0,0,2022-04-12 21:00:00+0000,2022-04-12 21:00:00+0000,0,,0
2022-04-15,86,191,0,2022-04-15 02:53:00+0000,2022-04-15 07:30:00+0000,0,,277
2022-04-16,98,208,94,2022-04-15 21:52:00+0000,2022-04-16 04:32:00+0000,0,,306
2022-04-17,145,266,0,2022-04-17 02:47:00+0000,2022-04-17 09:38:00+0000,0,,411
2022-04-18,50,67,0,2022-04-17 23:03:00+0000,2022-04-18 01:00:00+0000,0,,117
2022-04-19,50,174,0,2022-04-19 02:31:00+0000,2022-04-19 06:15:00+0000,0,,224
2022-04-20,60,397,0,2022-04-20 02:57:00+0000,2022-04-20 10:34:00+0000,0,,457
2022-04-21,54,243,2,2022-04-21 02:48:00+0000,2022-04-21 07:47:00+0000,0,,297
2022-04-22,87,182,0,2022-04-22 02:56:00+0000,2022-04-22 07:25:00+0000,0,,269
2022-04-23,200,259,5,2022-04-22 23:22:00+0000,2022-04-23 07:06:00+0000,0,,459
2022-04-24,117,267,59,2022-04-24 01:15:00+0000,2022-04-24 08:38:00+0000,0,,384
2022-04-25,73,288,0,2022-04-25 02:34:00+0000,2022-04-25 08:35:00+0000,0,,361
2022-04-26,67,121,0,2022-04-26 02:21:00+0000,2022-04-26 05:29:00+0000,0,,188
2022-04-27,219,338,77,2022-04-26 23:15:00+0000,2022-04-27 09:49:00+0000,0,,557
2022-04-28,27,99,0,2022-04-28 02:29:00+0000,2022-04-28 04:35:00+0000,0,,126
2022-04-29,54,120,0,2022-04-28 21:23:00+0000,2022-04-29 00:17:00+0000,0,,174
2022-04-30,0,0,0,2022-04-28 21:00:00+0000,2022-04-28 21:00:00+0000,0,,0
2022-05-01,214,406,71,2022-04-30 21:28:00+0000,2022-05-01 08:59:00+0000,0,,620
2022-05-02,74,125,0,2022-05-01 22:38:00+0000,2022-05-02 01:57:00+0000,0,,199
2022-05-03,219,360,90,2022-05-02 21:47:00+0000,2022-05-03 08:56:00+0000,0,,579
2022-05-04,132,267,3,2022-05-03 23:22:00+0000,2022-05-04 06:04:00+0000,0,,399
2022-05-05,155,319,0,2022-05-04 22:28:00+0000,2022-05-05 06:22:00+0000,0,,474
2022-05-06,102,409,23,2022-05-05 21:09:00+0000,2022-05-06 06:03:00+0000,0,,511
2022-05-07,179,311,0,2022-05-06 22:00:00+0000,2022-05-07 06:10:00+0000,0,,490
2022-05-08,119,396,23,2022-05-07 21:35:00+0000,2022-05-08 06:33:00+0000,0,,515
2022-05-09,128,315,41,2022-05-08 22:11:00+0000,2022-05-09 06:15:00+0000,0,,443
2022-05-10,182,445,2,2022-05-09 19:40:00+0000,2022-05-10 06:09:00+0000,0,,627
2022-05-11,57,228,9,2022-05-10 22:39:00+0000,2022-05-11 03:33:00+0000,0,,285
2022-05-12,69,165,0,2022-05-11 22:15:00+0000,2022-05-12 02:09:00+0000,0,,234
2022-05-13,150,341,0,2022-05-12 22:38:00+0000,2022-05-13 06:49:00+0000,0,,491
2022-05-14,46,153,0,2022-05-13 22:48:00+0000,2022-05-14 02:07:00+0000,0,,199
2022-05-15,125,530,2,2022-05-14 21:40:00+0000,2022-05-15 08:37:00+0000,0,,655
2022-05-16,0,101,0,2022-05-16 00:19:00+0000,2022-05-16 02:00:00+0000,0,,101
2022-05-17,163,336,0,2022-05-16 22:27:00+0000,2022-05-17 06:46:00+0000,0,,499
2022-05-18,86,321,2,2022-05-18 01:18:00+0000,2022-05-18 08:07:00+0000,0,,407
2022-05-19,15,108,0,2022-05-18 23:17:00+0000,2022-05-19 01:20:00+0000,0,,123
2022-05-20,183,456,0,2022-05-19 23:26:00+0000,2022-05-20 10:05:00+0000,0,,639
2022-05-21,50,215,2,2022-05-20 21:54:00+0000,2022-05-21 02:21:00+0000,0,,265
2022-05-22,0,0,0,2022-05-20 21:00:00+0000,2022-05-20 21:00:00+0000,0,,0
2022-05-23,140,463,10,2022-05-22 21:32:00+0000,2022-05-23 07:45:00+0000,0,,603
2022-05-24,127,405,0,2022-05-23 22:20:00+0000,2022-05-24 07:12:00+0000,0,,532
2022-05-25,42,195,0,2022-05-24 22:01:00+0000,2022-05-25 01:58:00+0000,0,,237
2022-05-26,104,259,64,2022-05-25 21:28:00+0000,2022-05-26 04:35:00+0000,0,,363
2022-05-27,133,356,54,2022-05-26 21:55:00+0000,2022-05-27 06:58:00+0000,0,,489
2022-05-28,0,86,0,2022-05-27 22:39:00+0000,2022-05-28 00:05:00+0000,0,,86
2022-05-29,68,213,0,2022-05-29 02:39:00+0000,2022-05-29 07:20:00+0000,0,,281
2022-05-30,118,284,50,2022-05-30 01:52:00+0000,2022-05-30 09:24:00+0000,0,,402
2022-05-31,73,259,0,2022-05-31 01:11:00+0000,2022-05-31 06:43:00+0000,0,,332
2022-06-01,141,445,0,2022-05-31 21:59:00+0000,2022-06-01 07:45:00+0000,0,,586
2022-06-02,98,323,11,2022-06-01 21:49:00+0000,2022-06-02 05:01:00+0000,0,,421
2022-06-03,88,260,0,2022-06-03 01:38:00+0000,2022-06-03 07:26:00+0000,0,,348
2022-06-04,26,154,0,2022-06-03 22:01:00+0000,2022-06-04 01:01:00+0000,0,,180
2022-06-05,134,442,0,2022-06-04 22:41:00+0000,2022-06-05 08:17:00+0000,0,,576
2022-06-06,0,121,0,2022-06-05 23:34:00+0000,2022-06-06 01:35:00+0000,0,,121
2022-06-07,104,306,37,2022-06-06 22:02:00+0000,2022-06-07 05:29:00+0000,0,,410
2022-06-08,23,170,0,2022-06-07 22:25:00+0000,2022-06-08 01:38:00+0000,0,,193
2022-06-09,86,102,2,2022-06-08 22:06:00+0000,2022-06-09 01:16:00+0000,0,,188
2022-06-10,149,387,11,2022-06-09 23:08:00+0000,2022-06-10 08:15:00+0000,0,,536
2022-06-11,47,282,32,2022-06-10 22:30:00+0000,2022-06-11 04:31:00+0000,0,,329
2022-06-12,25,120,0,2022-06-11 23:08:00+0000,2022-06-12 01:33:00+0000,0,,145
2022-06-13,28,189,0,2022-06-12 22:43:00+0000,2022-06-13 02:20:00+0000,0,,217
2022-06-14,64,88,0,2022-06-13 22:36:00+0000,2022-06-14 01:08:00+0000,0,,152
2022-06-15,125,368,61,2022-06-14 23:24:00+0000,2022-06-15 08:38:00+0000,0,,493
2022-06-16,116,309,7,2022-06-15 22:58:00+0000,2022-06-16 06:10:00+0000,0,,425
2022-06-17,199,299,0,2022-06-16 21:16:00+0000,2022-06-17 05:34:00+0000,0,,498
2022-06-18,68,252,0,2022-06-17 22:40:00+0000,2022-06-18 04:00:00+0000,0,,320
2022-06-19,50,181,0,2022-06-18 22:16:00+0000,2022-06-19 02:07:00+0000,0,,231
2022-06-20,125,303,10,2022-06-19 23:58:00+0000,2022-06-20 07:16:00+0000,0,,428
2022-06-21,43,194,0,2022-06-20 21:55:00+0000,2022-06-21 01:52:00+0000,0,,237
2022-06-22,54,327,15,2022-06-21 23:37:00+0000,2022-06-22 06:13:00+0000,0,,381
2022-06-23,195,263,0,2022-06-22 22:15:00+0000,2022-06-23 05:53:00+0000,0,,458
2022-06-24,92,348,2,2022-06-23 22:16:00+0000,2022-06-24 05:38:00+0000,0,,440
2022-06-25,47,139,28,2022-06-24 21:44:00+0000,2022-06-25 01:18:00+0000,0,,186
2022-06-26,183,318,0,2022-06-25 22:37:00+0000,2022-06-26 06:58:00+0000,0,,501
2022-06-27,136,327,0,2022-06-26 22:35:00+0000,2022-06-27 06:18:00+0000,0,,463
2022-06-28,36,124,0,2022-06-27 22:42:00+0000,2022-06-28 01:22:00+0000,0,,160
2022-06-29,147,344,0,2022-06-28 21:29:00+0000,2022-06-29 05:40:00+0000,0,,491
2022-06-30,103,402,0,2022-06-29 21:10:00+0000,2022-06-30 05:35:00+0000,0,,505
2022-07-01,46,132,0,2022-06-30 22:07:00+0000,2022-07-01 01:05:00+0000,0,,178
2022-07-02,141,274,74,2022-07-01 21:51:00+0000,2022-07-02 06:00:00+0000,0,,415
2022-07-03,158,411,0,2022-07-02 22:10:00+0000,2022-07-03 07:39:00+0000,0,,569
2022-07-04,155,350,2,2022-07-03 22:13:00+0000,2022-07-04 06:40:00+0000,0,,505
2022-07-05,144,330,0,2022-07-04 22:32:00+0000,2022-07-05 06:26:00+0000,0,,474
2022-07-06,186,318,2,2022-07-05 21:32:00+0000,2022-07-06 05:58:00+0000,0,,504
2022-07-07,170,290,0,2022-07-06 23:16:00+0000,2022-07-07 06:56:00+0000,0,,460
2022-07-08,167,342,0,2022-07-07 21:57:00+0000,2022-07-08 06:26:00+0000,0,,509
2022-07-09,128,201,0,2022-07-08 20:44:00+0000,2022-07-09 02:13:00+0000,0,,329
2022-07-10,64,249,0,2022-07-10 01:57:00+0000,2022-07-10 07:10:00+0000,0,,313
2022-07-11,212,343,0,2022-07-10 21:11:00+0000,2022-07-11 06:26:00+0000,0,,555
2022-07-12,55,177,0,2022-07-11 21:49:00+0000,2022-07-12 01:41:00+0000,0,,232
2022-07-13,120,374,0,2022-07-12 22:28:00+0000,2022-07-13 06:42:00+0000,0,,494
2022-07-14,45,163,0,2022-07-13 22:03:00+0000,2022-07-14 01:31:00+0000,0,,208
2022-07-15,108,384,0,2022-07-14 21:52:00+0000,2022-07-15 06:04:00+0000,0,,492
2022-07-16,128,383,0,2022-07-15 21:22:00+0000,2022-07-16 05:53:00+0000,0,,511
2022-07-17,51,150,0,2022-07-16 22:20:00+0000,2022-07-17 01:41:00+0000,0,,201
2022-07-18,188,458,2,2022-07-17 20:12:00+0000,2022-07-18 07:00:00+0000,0,,646
2022-07-19,146,374,0,2022-07-18 21:54:00+0000,2022-07-19 06:34:00+0000,0,,520
2022-07-20,175,323,0,2022-07-19 20:42:00+0000,2022-07-20 05:00:00+0000,0,,498
2022-07-21,177,341,0,2022-07-20 21:03:00+0000,2022-07-21 05:41:00+0000,0,,518
2022-07-22,119,408,5,2022-07-21 20:41:00+0000,2022-07-22 05:33:00+0000,0,,527
2022-07-23,144,414,0,2022-07-22 20:42:00+0000,2022-07-23 06:00:00+0000,0,,558
2022-07-24,170,344,0,2022-07-23 21:40:00+0000,2022-07-24 06:14:00+0000,0,,514
2022-07-25,41,201,0,2022-07-24 21:39:00+0000,2022-07-25 01:41:00+0000,0,,242
2022-07-26,146,362,0,2022-07-25 21:51:00+0000,2022-07-26 06:19:00+0000,0,,508
2022-07-27,124,355,2,2022-07-26 21:55:00+0000,2022-07-27 05:56:00+0000,0,,479
2022-07-28,84,321,0,2022-07-27 22:09:00+0000,2022-07-28 04:54:00+0000,0,,405
2022-07-29,72,178,0,2022-07-28 21:32:00+0000,2022-07-29 01:42:00+0000,0,,250
2022-07-30,173,382,0,2022-07-29 21:07:00+0000,2022-07-30 06:22:00+0000,0,,555
2022-07-31,45,189,0,2022-07-30 21:50:00+0000,2022-07-31 01:44:00+0000,0,,234
2022-08-01,106,364,0,2022-07-31 22:24:00+0000,2022-08-01 06:14:00+0000,0,,470
2022-08-02,169,315,0,2022-08-01 21:54:00+0000,2022-08-02 05:58:00+0000,0,,484
2022-08-03,133,356,0,2022-08-02 22:24:00+0000,2022-08-03 06:33:00+0000,0,,489
2022-08-04,0,0,0,2022-08-02 21:00:00+0000,2022-08-02 21:00:00+0000,0,,0
2022-08-17,106,220,0,2022-08-17 00:30:00+0000,2022-08-17 05:56:00+0000,0,,326
2022-08-18,125,400,11,2022-08-17 21:34:00+0000,2022-08-18 06:30:00+0000,0,,525
2022-08-19,147,427,0,2022-08-18 20:26:00+0000,2022-08-19 06:00:00+0000,0,,574
2022-08-20,133,398,2,2022-08-19 21:20:00+0000,2022-08-20 06:13:00+0000,0,,531
2022-08-21,35,182,0,2022-08-21 02:32:00+0000,2022-08-21 06:09:00+0000,0,,217
2022-08-22,151,323,0,2022-08-21 22:05:00+0000,2022-08-22 05:59:00+0000,0,,474
2022-08-23,214,355,0,2022-08-22 20:32:00+0000,2022-08-23 06:01:00+0000,0,,569
2022-08-24,145,365,0,2022-08-23 22:07:00+0000,2022-08-24 06:37:00+0000,0,,510
2022-08-25,148,303,0,2022-08-24 22:40:00+0000,2022-08-25 06:11:00+0000,0,,451
2022-08-26,171,311,0,2022-08-25 21:57:00+0000,2022-08-26 05:59:00+0000,0,,482
2022-08-27,144,363,0,2022-08-26 20:58:00+0000,2022-08-27 05:25:00+0000,0,,507
2022-08-28,87,436,2,2022-08-27 21:13:00+0000,2022-08-28 05:58:00+0000,0,,523
2022-08-29,0,0,0,2022-08-27 21:00:00+0000,2022-08-27 21:00:00+0000,0,,0
2022-08-30,71,215,0,2022-08-29 21:27:00+0000,2022-08-30 02:13:00+0000,0,,286
2022-08-31,136,312,0,2022-08-30 21:30:00+0000,2022-08-31 04:58:00+0000,0,,448
2022-09-01,0,0,0,2022-08-30 21:00:00+0000,2022-08-30 21:00:00+0000,0,,0
2022-09-02,23,138,0,2022-09-02 02:49:00+0000,2022-09-02 05:30:00+0000,0,,161
2022-09-03,0,0,0,2022-09-01 21:00:00+0000,2022-09-01 21:00:00+0000,0,,0
2022-09-04,128,303,0,2022-09-03 22:26:00+0000,2022-09-04 05:37:00+0000,0,,431
2022-09-05,163,354,0,2022-09-04 21:26:00+0000,2022-09-05 06:03:00+0000,0,,517
2022-09-06,126,376,0,2022-09-05 21:23:00+0000,2022-09-06 05:45:00+0000,0,,502
2022-09-07,100,408,0,2022-09-06 21:20:00+0000,2022-09-07 05:48:00+0000,0,,508
2022-09-08,97,195,0,2022-09-07 21:35:00+0000,2022-09-08 02:27:00+0000,0,,292
2022-09-09,43,257,0,2022-09-08 21:35:00+0000,2022-09-09 02:35:00+0000,0,,300
2022-09-10,205,349,0,2022-09-09 21:17:00+0000,2022-09-10 06:31:00+0000,0,,554
2022-09-11,13,125,2,2022-09-10 20:22:00+0000,2022-09-10 22:42:00+0000,0,,138
2022-09-12,108,375,2,2022-09-11 22:09:00+0000,2022-09-12 06:14:00+0000,0,,483
2022-09-13,140,348,0,2022-09-12 21:08:00+0000,2022-09-13 05:16:00+0000,0,,488
2022-09-14,142,381,0,2022-09-13 21:35:00+0000,2022-09-14 06:18:00+0000,0,,523
2022-09-15,0,0,0,2022-09-13 21:00:00+0000,2022-09-13 21:00:00+0000,0,,0
2022-09-16,133,390,0,2022-09-15 21:36:00+0000,2022-09-16 06:19:00+0000,0,,523
2022-09-17,102,371,0,2022-09-16 22:34:00+0000,2022-09-17 06:27:00+0000,0,,473
2022-09-18,120,413,2,2022-09-17 21:31:00+0000,2022-09-18 06:26:00+0000,0,,533
2022-09-19,101,442,0,2022-09-18 21:19:00+0000,2022-09-19 06:22:00+0000,0,,543
2022-09-20,127,316,0,2022-09-19 22:58:00+0000,2022-09-20 06:21:00+0000,0,,443
2022-09-21,149,462,0,2022-09-20 20:12:00+0000,2022-09-21 06:23:00+0000,0,,611
2022-09-22,175,349,2,2022-09-21 20:53:00+0000,2022-09-22 05:39:00+0000,0,,524
2022-09-23,130,368,0,2022-09-22 22:07:00+0000,2022-09-23 06:25:00+0000,0,,498
2022-09-24,162,353,2,2022-09-23 21:38:00+0000,2022-09-24 06:15:00+0000,0,,515
2022-09-25,97,380,57,2022-09-24 21:27:00+0000,2022-09-25 06:21:00+0000,0,,477
2022-09-26,191,337,2,2022-09-25 21:28:00+0000,2022-09-26 06:18:00+0000,0,,528
2022-09-27,172,355,69,2022-09-26 19:48:00+0000,2022-09-27 05:44:00+0000,0,,527
2022-09-28,134,412,0,2022-09-27 21:04:00+0000,2022-09-28 06:10:00+0000,0,,546
2022-09-29,147,366,0,2022-09-28 20:57:00+0000,2022-09-29 05:30:00+0000,0,,513
2022-09-30,160,420,11,2022-09-29 19:34:00+0000,2022-09-30 05:25:00+0000,0,,580
2022-10-01,118,332,0,2022-09-30 21:41:00+0000,2022-10-01 05:11:00+0000,0,,450
2022-10-02,172,400,0,2022-10-01 21:20:00+0000,2022-10-02 06:52:00+0000,0,,572
2022-10-03,66,308,0,2022-10-02 20:57:00+0000,2022-10-03 03:11:00+0000,0,,374
2022-10-04,67,373,0,2022-10-03 21:47:00+0000,2022-10-04 05:07:00+0000,0,,440
2022-10-05,139,259,2,2022-10-04 20:28:00+0000,2022-10-05 03:08:00+0000,0,,398
2022-10-06,94,301,17,2022-10-05 21:48:00+0000,2022-10-06 04:40:00+0000,0,,395
2022-10-07,81,310,26,2022-10-06 22:04:00+0000,2022-10-07 05:01:00+0000,0,,391
2022-10-08,123,343,32,2022-10-07 21:42:00+0000,2022-10-08 06:00:00+0000,0,,466
2022-10-09,116,423,22,2022-10-08 21:55:00+0000,2022-10-09 07:16:00+0000,0,,539
2022-10-10,136,250,11,2022-10-09 22:20:00+0000,2022-10-10 04:57:00+0000,0,,386
2022-10-11,85,237,0,2022-10-10 21:50:00+0000,2022-10-11 03:12:00+0000,0,,322
2022-10-12,83,360,22,2022-10-11 21:25:00+0000,2022-10-12 05:10:00+0000,0,,443
2022-10-13,85,298,22,2022-10-12 22:19:00+0000,2022-10-13 05:04:00+0000,0,,383
2022-10-14,159,340,23,2022-10-13 22:08:00+0000,2022-10-14 06:50:00+0000,0,,499
2022-10-15,160,402,2,2022-10-14 22:34:00+0000,2022-10-15 07:58:00+0000,0,,562
2022-10-16,127,468,8,2022-10-15 21:31:00+0000,2022-10-16 07:34:00+0000,0,,595
2022-10-17,62,264,0,2022-10-16 21:59:00+0000,2022-10-17 03:25:00+0000,0,,326
2022-10-18,174,402,26,2022-10-17 20:10:00+0000,2022-10-18 06:12:00+0000,0,,576
2022-10-19,120,364,24,2022-10-18 22:19:00+0000,2022-10-19 06:47:00+0000,0,,484
2022-10-20,63,322,0,2022-10-19 21:27:00+0000,2022-10-20 03:52:00+0000,0,,385
2022-10-21,148,205,0,2022-10-20 22:03:00+0000,2022-10-21 03:56:00+0000,0,,353
2022-10-22,93,283,0,2022-10-21 21:20:00+0000,2022-10-22 03:36:00+0000,0,,376
2022-11-09,0,0,0,2022-11-07 21:00:00+0000,2022-11-07 21:00:00+0000,0,,0
2022-11-10,143,361,19,2022-11-09 22:15:00+0000,2022-11-10 06:58:00+0000,0,,504
2022-11-11,208,204,32,2022-11-10 22:23:00+0000,2022-11-11 05:47:00+0000,0,,412
2022-11-12,78,347,22,2022-11-11 22:23:00+0000,2022-11-12 05:50:00+0000,0,,425
2022-11-13,137,404,41,2022-11-12 23:32:00+0000,2022-11-13 09:14:00+0000,0,,541
2022-11-14,89,322,15,2022-11-13 23:18:00+0000,2022-11-14 06:24:00+0000,0,,411
2022-11-15,105,311,0,2022-11-14 21:36:00+0000,2022-11-15 04:32:00+0000,0,,416
2022-11-16,170,322,36,2022-11-15 23:17:00+0000,2022-11-16 08:05:00+0000,0,,492
2022-11-17,108,384,0,2022-11-16 22:10:00+0000,2022-11-17 06:22:00+0000,0,,492
2022-11-18,88,308,0,2022-11-17 21:50:00+0000,2022-11-18 04:26:00+0000,0,,396
2022-11-19,178,483,0,2022-11-18 21:27:00+0000,2022-11-19 08:28:00+0000,0,,661
2022-11-20,58,387,25,2022-11-19 22:58:00+0000,2022-11-20 06:48:00+0000,0,,445
2022-11-21,115,348,0,2022-11-20 23:38:00+0000,2022-11-21 07:21:00+0000,0,,463
2022-11-22,59,341,14,2022-11-22 00:20:00+0000,2022-11-22 07:14:00+0000,0,,400
2022-11-23,63,327,39,2022-11-22 23:33:00+0000,2022-11-23 06:42:00+0000,0,,390
2022-11-24,144,298,48,2022-11-23 23:40:00+0000,2022-11-24 07:50:00+0000,0,,442
2022-11-25,97,335,21,2022-11-24 23:58:00+0000,2022-11-25 07:31:00+0000,0,,432
2022-11-26,73,210,3,2022-11-25 23:41:00+0000,2022-11-26 04:27:00+0000,0,,283
2022-11-27,120,380,16,2022-11-26 23:17:00+0000,2022-11-27 07:53:00+0000,0,,500
2022-11-28,98,360,28,2022-11-27 23:09:00+0000,2022-11-28 07:15:00+0000,0,,458
2022-11-29,119,358,16,2022-11-28 22:39:00+0000,2022-11-29 06:52:00+0000,0,,477
2022-11-30,89,309,0,2022-11-29 21:59:00+0000,2022-11-30 04:37:00+0000,0,,398
2022-12-01,147,285,0,2022-11-30 23:38:00+0000,2022-12-01 06:50:00+0000,0,,432
2022-12-02,121,210,0,2022-12-01 22:59:00+0000,2022-12-02 04:30:00+0000,0,,331
2022-12-03,95,453,32,2022-12-02 22:23:00+0000,2022-12-03 08:03:00+0000,0,,548
2022-12-04,98,401,13,2022-12-03 23:00:00+0000,2022-12-04 07:32:00+0000,0,,499
2022-12-05,104,269,0,2022-12-04 22:25:00+0000,2022-12-05 04:38:00+0000,0,,373
2022-12-06,139,320,87,2022-12-05 23:05:00+0000,2022-12-06 08:11:00+0000,0,,459
2022-12-07,122,421,15,2022-12-06 22:12:00+0000,2022-12-07 07:30:00+0000,0,,543
2022-12-08,106,377,22,2022-12-07 22:48:00+0000,2022-12-08 07:13:00+0000,0,,483
2022-12-09,105,220,0,2022-12-08 23:27:00+0000,2022-12-09 04:52:00+0000,0,,325
2022-12-10,106,364,0,2022-12-09 23:36:00+0000,2022-12-10 07:26:00+0000,0,,470
2022-12-11,193,307,0,2022-12-11 00:46:00+0000,2022-12-11 09:06:00+0000,0,,500
2022-12-12,93,358,26,2022-12-11 22:54:00+0000,2022-12-12 06:51:00+0000,0,,451
2022-12-13,118,265,0,2022-12-12 22:42:00+0000,2022-12-13 05:05:00+0000,0,,383
2022-12-14,84,299,0,2022-12-13 22:36:00+0000,2022-12-14 04:59:00+0000,0,,383
2022-12-15,164,254,0,2022-12-14 22:02:00+0000,2022-12-15 05:00:00+0000,0,,418
2022-12-16,113,364,28,2022-12-15 23:08:00+0000,2022-12-16 07:33:00+0000,0,,477
2022-12-17,97,300,0,2022-12-16 22:42:00+0000,2022-12-17 05:19:00+0000,0,,397
2022-12-18,131,387,8,2022-12-17 22:57:00+0000,2022-12-18 07:43:00+0000,0,,518
2022-12-19,85,425,51,2022-12-18 23:16:00+0000,2022-12-19 08:37:00+0000,0,,510
2022-12-20,99,359,16,2022-12-19 23:07:00+0000,2022-12-20 07:01:00+0000,0,,458
2022-12-21,181,401,2,2022-12-20 22:35:00+0000,2022-12-21 08:19:00+0000,0,,582
2022-12-22,149,377,13,2022-12-21 22:05:00+0000,2022-12-22 07:04:00+0000,0,,526
2022-12-23,116,348,9,2022-12-22 23:19:00+0000,2022-12-23 07:12:00+0000,0,,464
2022-12-24,106,433,2,2022-12-23 23:22:00+0000,2022-12-24 08:23:00+0000,0,,539
2022-12-25,0,0,0,2022-12-23 21:00:00+0000,2022-12-23 21:00:00+0000,0,,0
2022-12-26,64,376,17,2022-12-25 23:23:00+0000,2022-12-26 07:00:00+0000,0,,440
2022-12-27,153,295,43,2022-12-26 22:59:00+0000,2022-12-27 07:10:00+0000,0,,448
2022-12-28,125,371,28,2022-12-27 23:10:00+0000,2022-12-28 07:54:00+0000,0,,496
2022-12-29,61,367,29,2022-12-28 23:29:00+0000,2022-12-29 07:06:00+0000,0,,428
2022-12-30,83,264,2,2022-12-29 23:01:00+0000,2022-12-30 04:50:00+0000,0,,347
2022-12-31,87,413,0,2022-12-30 23:24:00+0000,2022-12-31 07:44:00+0000,0,,500
2023-01-01,130,360,0,2022-12-31 23:33:00+0000,2023-01-01 07:43:00+0000,0,,490
2023-01-02,158,313,0,2023-01-02 00:05:00+0000,2023-01-02 07:56:00+0000,0,,471
2023-01-03,123,376,0,2023-01-02 22:35:00+0000,2023-01-03 06:54:00+0000,0,,499
2023-01-04,153,419,2,2023-01-03 22:15:00+0000,2023-01-04 07:49:00+0000,0,,572
2023-01-05,164,281,0,2023-01-04 23:40:00+0000,2023-01-05 07:05:00+0000,0,,445
2023-01-06,133,395,31,2023-01-05 23:50:00+0000,2023-01-06 09:09:00+0000,0,,528
2023-01-07,90,380,52,2023-01-06 23:54:00+0000,2023-01-07 08:36:00+0000,0,,470
2023-01-08,144,333,2,2023-01-07 23:52:00+0000,2023-01-08 07:51:00+0000,0,,477
2023-01-09,114,378,27,2023-01-08 23:44:00+0000,2023-01-09 08:23:00+0000,0,,492
2023-01-10,86,295,0,2023-01-09 22:34:00+0000,2023-01-10 04:55:00+0000,0,,381
2023-01-11,0,0,0,2023-01-09 21:00:00+0000,2023-01-09 21:00:00+0000,0,,0
2023-01-12,156,422,18,2023-01-11 22:52:00+0000,2023-01-12 08:48:00+0000,0,,578
2023-01-13,133,346,21,2023-01-13 00:07:00+0000,2023-01-13 08:27:00+0000,0,,479
2023-01-14,139,353,58,2023-01-13 23:04:00+0000,2023-01-14 08:14:00+0000,0,,492
2023-01-15,109,385,20,2023-01-15 00:04:00+0000,2023-01-15 08:38:00+0000,0,,494
2023-01-16,97,299,0,2023-01-15 22:23:00+0000,2023-01-16 04:59:00+0000,0,,396
2023-01-17,105,377,0,2023-01-16 23:27:00+0000,2023-01-17 07:29:00+0000,0,,482
2023-01-18,92,243,0,2023-01-17 23:24:00+0000,2023-01-18 04:59:00+0000,0,,335
2023-01-19,97,314,0,2023-01-18 22:23:00+0000,2023-01-19 05:14:00+0000,0,,411
2023-01-20,157,214,0,2023-01-20 00:24:00+0000,2023-01-20 06:35:00+0000,0,,371
2023-01-21,97,203,0,2023-01-20 22:59:00+0000,2023-01-21 03:59:00+0000,0,,300
2023-01-22,97,185,0,2023-01-21 23:11:00+0000,2023-01-22 03:53:00+0000,0,,282
2023-01-23,56,257,0,2023-01-22 21:32:00+0000,2023-01-23 02:45:00+0000,0,,313
2023-01-24,66,234,0,2023-01-23 23:02:00+0000,2023-01-24 04:02:00+0000,0,,300
2023-01-25,183,284,0,2023-01-24 22:37:00+0000,2023-01-25 06:24:00+0000,0,,467
2023-01-26,163,323,0,2023-01-25 23:02:00+0000,2023-01-26 07:08:00+0000,0,,486
2023-01-27,82,289,0,2023-01-26 21:54:00+0000,2023-01-27 04:05:00+0000,0,,371
2023-01-28,162,426,2,2023-01-27 22:03:00+0000,2023-01-28 07:53:00+0000,0,,588
2023-01-29,31,111,0,2023-01-28 21:42:00+0000,2023-01-29 00:04:00+0000,0,,142
2023-01-30,131,353,2,2023-01-29 19:39:00+0000,2023-01-30 03:45:00+0000,0,,484
2023-01-31,128,297,0,2023-01-30 20:43:00+0000,2023-01-31 03:48:00+0000,0,,425
2023-02-01,156,237,0,2023-01-31 21:17:00+0000,2023-02-01 03:50:00+0000,0,,393
2023-02-02,104,259,0,2023-02-01 21:54:00+0000,2023-02-02 03:57:00+0000,0,,363
2023-02-03,127,240,0,2023-02-02 21:43:00+0000,2023-02-03 03:50:00+0000,0,,367
2023-02-04,209,468,0,2023-02-03 21:49:00+0000,2023-02-04 09:06:00+0000,0,,677
2023-02-05,73,377,0,2023-02-04 21:26:00+0000,2023-02-05 04:56:00+0000,0,,450
2023-02-06,111,311,0,2023-02-05 21:00:00+0000,2023-02-06 04:02:00+0000,0,,422
2023-02-07,197,422,2,2023-02-06 22:09:00+0000,2023-02-07 08:30:00+0000,0,,619
2023-02-08,99,308,0,2023-02-07 21:18:00+0000,2023-02-08 04:05:00+0000,0,,407
2023-02-09,122,312,3,2023-02-08 20:36:00+0000,2023-02-09 03:53:00+0000,0,,434
2023-02-10,106,336,0,2023-02-09 20:36:00+0000,2023-02-10 03:58:00+0000,0,,442
2023-02-11,102,291,0,2023-02-10 22:03:00+0000,2023-02-11 04:36:00+0000,0,,393
2023-02-12,79,243,0,2023-02-11 22:21:00+0000,2023-02-12 03:43:00+0000,0,,322
2023-02-13,148,418,0,2023-02-12 21:33:00+0000,2023-02-13 06:59:00+0000,0,,566
2023-02-14,67,226,0,2023-02-13 22:47:00+0000,2023-02-14 03:40:00+0000,0,,293
2023-02-15,91,254,0,2023-02-14 21:55:00+0000,2023-02-15 03:40:00+0000,0,,345
2023-02-16,48,290,0,2023-02-15 22:04:00+0000,2023-02-16 03:42:00+0000,0,,338
2023-02-17,123,350,4,2023-02-16 22:24:00+0000,2023-02-17 06:21:00+0000,0,,473
2023-02-18,174,356,2,2023-02-17 21:08:00+0000,2023-02-18 06:00:00+0000,0,,530
2023-02-19,157,359,2,2023-02-18 22:25:00+0000,2023-02-19 07:03:00+0000,0,,516
2023-02-20,79,254,0,2023-02-19 22:04:00+0000,2023-02-20 03:37:00+0000,0,,333
2023-02-21,38,320,0,2023-02-20 21:35:00+0000,2023-02-21 03:33:00+0000,0,,358
2023-02-22,195,350,2,2023-02-21 22:52:00+0000,2023-02-22 07:59:00+0000,0,,545
2023-02-23,97,216,0,2023-02-22 22:19:00+0000,2023-02-23 03:32:00+0000,0,,313
2023-02-24,160,317,0,2023-02-23 22:17:00+0000,2023-02-24 06:14:00+0000,0,,477
2023-02-25,84,398,0,2023-02-24 21:44:00+0000,2023-02-25 05:46:00+0000,0,,482
2023-02-26,193,308,0,2023-02-25 22:13:00+0000,2023-02-26 06:34:00+0000,0,,501
2023-02-27,171,407,0,2023-02-26 20:51:00+0000,2023-02-27 06:29:00+0000,0,,578
2023-02-28,64,434,0,2023-02-27 21:26:00+0000,2023-02-28 05:44:00+0000,0,,498
2023-03-01,77,505,19,2023-02-28 20:50:00+0000,2023-03-01 06:51:00+0000,0,,582
2023-03-02,93,339,0,2023-03-01 20:54:00+0000,2023-03-02 04:06:00+0000,0,,432
2023-03-03,136,352,2,2023-03-02 22:52:00+0000,2023-03-03 07:02:00+0000,0,,488
2023-03-04,191,445,2,2023-03-03 21:56:00+0000,2023-03-04 08:34:00+0000,0,,636
2023-03-05,95,423,0,2023-03-04 21:41:00+0000,2023-03-05 06:19:00+0000,0,,518
2023-03-06,105,382,4,2023-03-05 22:13:00+0000,2023-03-06 06:24:00+0000,0,,487
2023-03-07,117,368,0,2023-03-06 21:50:00+0000,2023-03-07 05:55:00+0000,0,,485
2023-03-08,125,327,18,2023-03-07 22:46:00+0000,2023-03-08 06:36:00+0000,0,,452
2023-03-09,117,321,62,2023-03-08 22:25:00+0000,2023-03-09 06:45:00+0000,0,,438
2023-03-10,121,357,0,2023-03-09 23:44:00+0000,2023-03-10 07:42:00+0000,0,,478
2023-03-11,32,399,58,2023-03-10 21:32:00+0000,2023-03-11 05:41:00+0000,0,,431
2023-03-12,41,253,0,2023-03-11 23:18:00+0000,2023-03-12 04:12:00+0000,0,,294
2023-03-13,103,322,4,2023-03-12 23:34:00+0000,2023-03-13 06:43:00+0000,0,,425
2023-03-14,80,410,14,2023-03-13 22:51:00+0000,2023-03-14 07:15:00+0000,0,,490
2023-03-15,67,484,2,2023-03-14 21:50:00+0000,2023-03-15 07:03:00+0000,0,,551
2023-03-16,146,357,2,2023-03-15 22:25:00+0000,2023-03-16 06:50:00+0000,0,,503
2023-03-17,56,458,0,2023-03-16 22:49:00+0000,2023-03-17 07:23:00+0000,0,,514
2023-03-18,54,320,0,2023-03-17 21:37:00+0000,2023-03-18 03:51:00+0000,0,,374
2023-03-19,171,397,2,2023-03-18 22:33:00+0000,2023-03-19 08:03:00+0000,0,,568
2023-03-20,94,370,11,2023-03-19 23:19:00+0000,2023-03-20 07:14:00+0000,0,,464
2023-03-21,82,223,0,2023-03-20 22:42:00+0000,2023-03-21 03:47:00+0000,0,,305
2023-03-22,121,444,0,2023-03-21 22:11:00+0000,2023-03-22 07:36:00+0000,0,,565
2023-03-23,33,158,0,2023-03-22 22:09:00+0000,2023-03-23 01:20:00+0000,0,,191
2023-03-24,46,81,0,2023-03-23 23:11:00+0000,2023-03-24 01:18:00+0000,0,,127
2023-03-25,58,91,0,2023-03-24 23:06:00+0000,2023-03-25 01:35:00+0000,0,,149
2023-03-26,0,161,0,2023-03-25 22:18:00+0000,2023-03-26 00:59:00+0000,0,,161
2023-03-27,0,109,0,2023-03-26 23:38:00+0000,2023-03-27 01:27:00+0000,0,,109
2023-03-28,30,111,0,2023-03-27 22:56:00+0000,2023-03-28 01:17:00+0000,0,,141
2023-03-29,27,92,0,2023-03-28 23:16:00+0000,2023-03-29 01:15:00+0000,0,,119
2023-03-30,79,84,0,2023-03-29 22:39:00+0000,2023-03-30 01:22:00+0000,0,,163
2023-03-31,14,100,0,2023-03-30 23:32:00+0000,2023-03-31 01:26:00+0000,0,,114
2023-04-01,15,58,0,2023-03-31 23:59:00+0000,2023-04-01 01:12:00+0000,0,,73
2023-04-17,0,0,0,2023-04-15 21:00:00+0000,2023-04-15 21:00:00+0000,0,,0
2023-04-18,24,313,0,2023-04-18 02:53:00+0000,2023-04-18 08:30:00+0000,0,,337
2023-04-19,117,350,69,2023-04-18 22:38:00+0000,2023-04-19 07:34:00+0000,0,,467
2023-04-20,57,349,0,2023-04-20 02:04:00+0000,2023-04-20 08:50:00+0000,0,,406
2023-04-21,41,260,2,2023-04-20 22:03:00+0000,2023-04-21 03:06:00+0000,0,,301
2023-04-22,179,527,154,2023-04-21 18:59:00+0000,2023-04-22 09:19:00+0000,0,,706
2023-04-23,119,356,22,2023-04-22 21:25:00+0000,2023-04-23 05:42:00+0000,0,,475
2023-04-24,44,203,0,2023-04-23 21:48:00+0000,2023-04-24 01:55:00+0000,0,,247
2023-04-25,81,142,0,2023-04-24 22:09:00+0000,2023-04-25 01:52:00+0000,0,,223
2023-04-26,88,211,0,2023-04-25 21:09:00+0000,2023-04-26 02:08:00+0000,0,,299
2023-04-27,207,518,33,2023-04-26 18:51:00+0000,2023-04-27 07:29:00+0000,0,,725
2023-04-28,101,339,2,2023-04-27 22:08:00+0000,2023-04-28 05:30:00+0000,0,,440
2023-04-29,141,340,2,2023-04-28 20:56:00+0000,2023-04-29 04:59:00+0000,0,,481
2023-04-30,99,273,55,2023-04-29 22:53:00+0000,2023-04-30 06:00:00+0000,0,,372
2023-05-01,166,303,2,2023-04-30 22:40:00+0000,2023-05-01 06:31:00+0000,0,,469
2023-05-02,175,264,20,2023-05-01 23:01:00+0000,2023-05-02 06:40:00+0000,0,,439
2023-05-03,136,367,0,2023-05-02 22:01:00+0000,2023-05-03 06:24:00+0000,0,,503
2023-05-04,118,380,0,2023-05-03 21:22:00+0000,2023-05-04 05:40:00+0000,0,,498
2023-05-05,158,383,42,2023-05-04 22:19:00+0000,2023-05-05 08:02:00+0000,0,,541
